año;mes;nacion;1 estrella;2 estrellas;3 estrellas;4 estrellas;5 estrellas;hoteleros;extrahoteleros;total
2010;1;España;898;4365;16498;33170;6804;61735;14977;76712
2010;1;Holanda;80;164;1434;3429;491;5598;4945;10543
2010;1;Bélgica;58;97;969;6373;1564;9061;2324;11385
2010;1;Alemania;402;656;7349;26814;5127;40348;11110;51458
2010;1;Francia;123;601;888;3726;491;5829;3187;9016
2010;1;Gran Bretaña;919;672;11708;35347;6392;55038;59779;114817
2010;1;Irlanda;12;70;815;1944;741;3582;2908;6490
2010;1;Italia;57;238;1035;4860;1012;7202;2562;9764
2010;1;Suecia;36;225;1497;5260;370;7388;11689;19077
2010;1;Noruega;10;138;1307;1936;477;3868;9474;13342
2010;1;Dinamarca;16;578;1330;2236;115;4275;8421;12696
2010;1;Finlandia;12;70;1927;2645;314;4968;13092;18060
2010;1;Suiza;38;102;236;788;375;1539;679;2218
2010;1;Austria;13;46;328;1372;397;2156;1150;3306
2010;1;Rusia;83;15;499;1511;1064;3172;2946;6118
2010;1;Países del Este;49;195;888;1642;345;3119;2710;5829
2010;1;Resto de Europa;45;124;1160;1835;465;3629;1700;5329
2010;1;Estados Unidos;16;37;152;188;167;560;293;853
2010;1;Resto de América;78;204;341;232;189;1044;484;1528
2010;1;Resto del Mundo;42;159;500;1307;378;2386;1310;3696
2010;1;TOTAL;2987;8756;50861;136615;27278;226497;155740;382237
2010;2;España;1511;5422;17628;34894;7319;66774;15236;82010
2010;2;Holanda;87;265;1341;4033;804;6530;5970;12500
2010;2;Bélgica;33;72;726;5657;1802;8290;1897;10187
2010;2;Alemania;381;604;7543;23024;4734;36286;9917;46203
2010;2;Francia;215;780;1427;4166;620;7208;3863;11071
2010;2;Gran Bretaña;858;537;9393;35323;8155;54266;58173;112439
2010;2;Irlanda;13;63;852;1870;761;3559;2801;6360
2010;2;Italia;113;234;1055;4308;772;6482;1978;8460
2010;2;Suecia;29;197;1351;4079;336;5992;10013;16005
2010;2;Noruega;17;117;1053;1864;260;3311;8331;11642
2010;2;Dinamarca;11;484;1260;2542;227;4524;8611;13135
2010;2;Finlandia;13;83;1442;2419;381;4338;10895;15233
2010;2;Suiza;59;64;270;884;478;1755;607;2362
2010;2;Austria;26;69;268;1123;321;1807;973;2780
2010;2;Rusia;68;33;338;600;533;1572;2025;3597
2010;2;Países del Este;50;143;642;2136;141;3112;2011;5123
2010;2;Resto de Europa;23;84;1149;1970;497;3723;1387;5110
2010;2;Estados Unidos;7;51;125;220;170;573;195;768
2010;2;Resto de América;100;221;362;220;137;1040;309;1349
2010;2;Resto del Mundo;70;123;398;1242;241;2074;1139;3213
2010;2;TOTAL;3684;9646;48623;132574;28689;223216;146331;369547
2010;3;España;1135;5229;19132;40188;10162;75846;25414;101260
2010;3;Holanda;94;189;1562;3122;678;5645;5319;10964
2010;3;Bélgica;45;68;576;4448;1638;6775;1750;8525
2010;3;Alemania;501;716;8679;24743;5145;39784;10361;50145
2010;3;Francia;162;858;1150;3903;463;6536;2732;9268
2010;3;Gran Bretaña;752;509;10025;39774;8391;59451;65900;125351
2010;3;Irlanda;18;53;677;1835;704;3287;3235;6522
2010;3;Italia;34;153;1109;2884;1037;5217;1678;6895
2010;3;Suecia;2;162;1644;4686;396;6890;10393;17283
2010;3;Noruega;3;56;964;1989;297;3309;8530;11839
2010;3;Dinamarca;11;471;1246;2780;238;4746;7501;12247
2010;3;Finlandia;15;81;1332;3116;342;4886;11169;16055
2010;3;Suiza;25;54;320;727;489;1615;700;2315
2010;3;Austria;10;37;267;1150;271;1735;928;2663
2010;3;Rusia;111;32;409;830;621;2003;2669;4672
2010;3;Países del Este;33;119;703;1724;351;2930;2545;5475
2010;3;Resto de Europa;24;95;1029;2350;534;4032;1533;5565
2010;3;Estados Unidos;18;91;157;409;198;873;398;1271
2010;3;Resto de América;69;187;278;195;113;842;565;1407
2010;3;Resto del Mundo;65;170;462;2234;594;3525;1114;4639
2010;3;TOTAL;3127;9330;51721;143087;32662;239927;164434;404361
2010;4;España;961;5041;22467;53924;9894;92287;40669;132956
2010;4;Holanda;27;97;910;4700;713;6447;5331;11778
2010;4;Bélgica;13;75;1105;7680;1915;10788;2160;12948
2010;4;Alemania;233;480;8651;22515;4330;36209;8993;45202
2010;4;Francia;123;724;1765;5480;638;8730;4814;13544
2010;4;Gran Bretaña;898;322;8287;48236;10406;68149;70781;138930
2010;4;Irlanda;3;72;515;1628;626;2844;3091;5935
2010;4;Italia;63;148;821;2592;509;4133;1204;5337
2010;4;Suecia;18;145;646;2301;165;3275;5544;8819
2010;4;Noruega;1;72;166;675;85;999;2408;3407
2010;4;Dinamarca;1;305;633;914;107;1960;2570;4530
2010;4;Finlandia;6;27;563;947;112;1655;3961;5616
2010;4;Suiza;31;63;295;1125;445;1959;852;2811
2010;4;Austria;13;16;226;1166;190;1611;872;2483
2010;4;Rusia;97;27;459;1639;818;3040;3911;6951
2010;4;Países del Este;42;293;754;1864;292;3245;2533;5778
2010;4;Resto de Europa;27;76;1103;2839;474;4519;1784;6303
2010;4;Estados Unidos;0;45;230;365;200;840;469;1309
2010;4;Resto de América;79;215;290;359;89;1032;403;1435
2010;4;Resto del Mundo;45;205;392;4183;405;5230;1247;6477
2010;4;TOTAL;2681;8448;50278;165132;32413;258952;163597;422549
2010;5;España;978;5038;26418;59875;9770;102079;37498;139577
2010;5;Holanda;62;111;1135;4670;1010;6988;6362;13350
2010;5;Bélgica;37;70;546;5554;1308;7515;1306;8821
2010;5;Alemania;174;284;7206;20518;4063;32245;6307;38552
2010;5;Francia;160;599;876;3747;428;5810;2318;8128
2010;5;Gran Bretaña;937;246;6995;36201;8626;53005;56469;109474
2010;5;Irlanda;14;22;528;1193;483;2240;3435;5675
2010;5;Italia;31;111;768;2443;497;3850;1388;5238
2010;5;Suecia;6;27;70;139;36;278;788;1066
2010;5;Noruega;3;185;102;80;66;436;603;1039
2010;5;Dinamarca;0;171;76;401;43;691;983;1674
2010;5;Finlandia;0;23;47;23;15;108;119;227
2010;5;Suiza;44;41;193;918;448;1644;697;2341
2010;5;Austria;4;22;126;669;274;1095;419;1514
2010;5;Rusia;87;13;249;1249;877;2475;3162;5637
2010;5;Países del Este;35;85;875;993;289;2277;2177;4454
2010;5;Resto de Europa;22;49;1106;3616;1135;5928;1669;7597
2010;5;Estados Unidos;4;34;131;177;268;614;287;901
2010;5;Resto de América;77;147;291;334;132;981;580;1561
2010;5;Resto del Mundo;26;188;314;2058;484;3070;1401;4471
2010;5;TOTAL;2701;7466;48052;144858;30252;233329;127968;361297
2010;6;España;1031;5395;23225;61206;10509;101366;42954;144320
2010;6;Holanda;20;40;682;2507;363;3612;3326;6938
2010;6;Bélgica;44;42;517;6162;971;7736;1178;8914
2010;6;Alemania;91;210;7165;19188;2881;29535;5146;34681
2010;6;Francia;41;301;473;2284;315;3414;2654;6068
2010;6;Gran Bretaña;754;264;6783;35993;8141;51935;68296;120231
2010;6;Irlanda;3;26;452;1222;448;2151;3813;5964
2010;6;Italia;74;118;863;2543;522;4120;1780;5900
2010;6;Suecia;3;15;119;297;28;462;1149;1611
2010;6;Noruega;0;222;118;172;53;565;662;1227
2010;6;Dinamarca;1;146;85;532;38;802;689;1491
2010;6;Finlandia;0;11;27;22;7;67;343;410
2010;6;Suiza;7;8;206;795;356;1372;580;1952
2010;6;Austria;4;21;142;1025;189;1381;356;1737
2010;6;Rusia;203;12;328;1535;1153;3231;3696;6927
2010;6;Países del Este;39;226;1400;2643;473;4781;3228;8009
2010;6;Resto de Europa;11;78;1311;4088;537;6025;1600;7625
2010;6;Estados Unidos;4;37;141;428;215;825;429;1254
2010;6;Resto de América;49;199;423;281;97;1049;644;1693
2010;6;Resto del Mundo;31;224;507;5288;374;6424;1567;7991
2010;6;TOTAL;2410;7595;44967;148211;27670;230853;144090;374943
2010;7;España;961;5087;22272;76741;15070;120131;53781;173912
2010;7;Holanda;50;90;1274;4245;616;6275;8118;14393
2010;7;Bélgica;8;52;638;7159;1380;9237;3085;12322
2010;7;Alemania;146;233;8661;19715;2454;31209;7449;38658
2010;7;Francia;63;305;830;3338;490;5026;5226;10252
2010;7;Gran Bretaña;913;197;9646;37074;9016;56846;79416;136262
2010;7;Irlanda;13;16;476;1251;435;2191;4203;6394
2010;7;Italia;71;121;1150;3245;269;4856;3444;8300
2010;7;Suecia;12;8;130;297;62;509;1467;1976
2010;7;Noruega;8;144;92;291;84;619;1458;2077
2010;7;Dinamarca;0;180;73;493;53;799;884;1683
2010;7;Finlandia;1;29;24;36;14;104;268;372
2010;7;Suiza;21;25;332;1426;410;2214;995;3209
2010;7;Austria;4;19;209;1549;190;1971;714;2685
2010;7;Rusia;213;9;427;2059;1813;4521;5577;10098
2010;7;Países del Este;41;288;1390;3109;1124;5952;3827;9779
2010;7;Resto de Europa;20;38;2069;5121;472;7720;3020;10740
2010;7;Estados Unidos;5;51;242;447;223;968;538;1506
2010;7;Resto de América;80;211;547;354;156;1348;757;2105
2010;7;Resto del Mundo;39;169;454;1453;443;2558;1978;4536
2010;7;TOTAL;2669;7272;50936;169403;34774;265054;186205;451259
2010;8;España;790;4626;24696;90079;19478;139669;63511;203180
2010;8;Holanda;27;96;1375;4328;451;6277;7261;13538
2010;8;Bélgica;20;36;633;6234;955;7878;2321;10199
2010;8;Alemania;229;275;8034;18160;2877;29575;7404;36979
2010;8;Francia;82;311;886;3631;778;5688;4055;9743
2010;8;Gran Bretaña;444;235;9652;35486;7282;53099;71513;124612
2010;8;Irlanda;5;12;522;1119;296;1954;2855;4809
2010;8;Italia;95;340;1931;5874;628;8868;6343;15211
2010;8;Suecia;2;15;65;472;29;583;872;1455
2010;8;Noruega;3;335;94;281;29;742;727;1469
2010;8;Dinamarca;2;157;79;372;5;615;556;1171
2010;8;Finlandia;0;51;18;11;1;81;293;374
2010;8;Suiza;14;23;152;925;287;1401;464;1865
2010;8;Austria;6;15;146;1097;246;1510;567;2077
2010;8;Rusia;133;18;466;2489;1760;4866;4128;8994
2010;8;Países del Este;22;177;1255;2450;869;4773;2722;7495
2010;8;Resto de Europa;19;63;2410;6922;1268;10682;3182;13864
2010;8;Estados Unidos;4;24;117;169;149;463;298;761
2010;8;Resto de América;64;226;545;382;144;1361;892;2253
2010;8;Resto del Mundo;20;140;436;1969;656;3221;1928;5149
2010;8;TOTAL;1981;7175;53512;182450;38188;283306;181892;465198
2010;9;España;912;4516;16460;58806;13289;93983;35275;129258
2010;9;Holanda;31;82;767;3385;542;4807;4421;9228
2010;9;Bélgica;18;57;571;6280;1167;8093;1715;9808
2010;9;Alemania;196;445;7358;22325;4316;34640;7293;41933
2010;9;Francia;56;308;554;2440;331;3689;2595;6284
2010;9;Gran Bretaña;835;295;9639;35279;7648;53696;61242;114938
2010;9;Irlanda;1;7;820;1173;380;2381;2559;4940
2010;9;Italia;104;107;1132;3241;372;4956;1541;6497
2010;9;Suecia;15;10;102;405;10;542;1225;1767
2010;9;Noruega;3;5;42;241;44;335;863;1198
2010;9;Dinamarca;11;13;104;405;44;577;498;1075
2010;9;Finlandia;0;31;16;8;2;57;168;225
2010;9;Suiza;25;60;244;948;372;1649;841;2490
2010;9;Austria;17;24;211;1111;223;1586;564;2150
2010;9;Rusia;141;9;300;1820;1063;3333;4013;7346
2010;9;Países del Este;46;410;1111;2175;606;4348;3689;8037
2010;9;Resto de Europa;22;133;1221;4149;586;6111;2251;8362
2010;9;Estados Unidos;2;24;150;283;206;665;268;933
2010;9;Resto de América;54;192;423;249;112;1030;674;1704
2010;9;Resto del Mundo;21;113;390;3282;262;4068;1432;5500
2010;9;TOTAL;2510;6841;41615;148005;31575;230546;133127;363673
2010;10;España;1250;5615;17218;50598;12094;86775;23268;110043
2010;10;Holanda;150;125;1256;4999;1213;7743;6173;13916
2010;10;Bélgica;46;63;812;5845;1918;8684;1340;10024
2010;10;Alemania;492;680;8230;22666;6949;39017;9149;48166
2010;10;Francia;111;325;1404;3282;816;5938;3916;9854
2010;10;Gran Bretaña;35;555;11680;52654;12965;77889;76667;154556
2010;10;Irlanda;3;53;780;1801;575;3212;2924;6136
2010;10;Italia;71;132;902;1555;424;3084;1401;4485
2010;10;Suecia;4;106;944;3210;410;4674;7712;12386
2010;10;Noruega;0;90;696;1381;288;2455;5691;8146
2010;10;Dinamarca;4;347;427;1880;203;2861;4481;7342
2010;10;Finlandia;2;18;1039;2398;406;3863;7612;11475
2010;10;Suiza;57;131;449;1439;789;2865;1278;4143
2010;10;Austria;7;58;206;1160;396;1827;738;2565
2010;10;Rusia;4;59;288;1734;1415;3500;4961;8461
2010;10;Países del Este;28;322;1255;1599;654;3858;2630;6488
2010;10;Resto de Europa;58;134;1072;3417;799;5480;2165;7645
2010;10;Estados Unidos;14;51;147;327;294;833;209;1042
2010;10;Resto de América;77;232;285;318;150;1062;417;1479
2010;10;Resto del Mundo;45;143;319;2751;388;3646;1609;5255
2010;10;TOTAL;2458;9239;49409;165014;43146;269266;164341;433607
2010;11;España;1243;6180;13146;37611;5523;63703;16610;80313
2010;11;Holanda;66;199;1463;4199;925;6852;4535;11387
2010;11;Bélgica;45;89;773;6299;2304;9510;2296;11806
2010;11;Alemania;340;993;9437;25782;8353;44905;9216;54121
2010;11;Francia;158;634;1253;2083;782;4910;2962;7872
2010;11;Gran Bretaña;558;1403;9516;39641;6642;57760;64695;122455
2010;11;Irlanda;9;98;472;1510;436;2525;2277;4802
2010;11;Italia;115;205;1071;2497;428;4316;1958;6274
2010;11;Suecia;16;84;2100;6515;535;9250;12642;21892
2010;11;Noruega;3;35;1369;1900;234;3541;9541;13082
2010;11;Dinamarca;10;47;727;2252;165;3201;6898;10099
2010;11;Finlandia;9;72;2330;3201;255;5867;13527;19394
2010;11;Suiza;10;163;240;1024;840;2277;886;3163
2010;11;Austria;14;55;406;1363;446;2284;1150;3434
2010;11;Rusia;58;32;326;1505;742;2663;3929;6592
2010;11;Países del Este;43;206;797;2284;446;3776;2005;5781
2010;11;Resto de Europa;24;141;1298;2082;442;3987;2846;6833
2010;11;Estados Unidos;7;53;95;267;193;615;232;847
2010;11;Resto de América;81;202;286;141;110;820;228;1048
2010;11;Resto del Mundo;51;148;536;2076;1235;4046;1398;5444
2010;11;TOTAL;2860;11039;47641;144232;31036;236808;159831;396639
2010;12;España;1487;5547;17348;42099;7749;74230;18413;92643
2010;12;Holanda;127;204;1708;3956;745;6740;5966;12706
2010;12;Bélgica;54;126;661;6539;1587;8967;2946;11913
2010;12;Alemania;456;1156;7368;25503;5036;39519;10737;50256
2010;12;Francia;215;984;1574;2854;823;6450;3353;9803
2010;12;Gran Bretaña;800;922;9796;38428;9911;59857;65379;125236
2010;12;Irlanda;13;79;427;1152;475;2146;1675;3821
2010;12;Italia;99;299;1021;3306;767;5492;2558;8050
2010;12;Suecia;19;67;1155;5406;395;7042;10559;17601
2010;12;Noruega;29;56;831;1796;288;3000;7959;10959
2010;12;Dinamarca;13;42;835;2058;116;3064;8029;11093
2010;12;Finlandia;5;65;1860;3567;503;6000;14684;20684
2010;12;Suiza;31;56;213;861;387;1548;645;2193
2010;12;Austria;15;56;254;1184;370;1879;901;2780
2010;12;Rusia;144;60;202;1314;1057;2777;3822;6599
2010;12;Países del Este;19;330;551;2331;395;3626;1839;5465
2010;12;Resto de Europa;10;104;1348;2117;570;4149;3089;7238
2010;12;Estados Unidos;14;97;160;282;254;807;433;1240
2010;12;Resto de América;79;258;363;247;105;1052;497;1549
2010;12;Resto del Mundo;36;205;293;1014;562;2110;2076;4186
2010;12;TOTAL;3665;10713;47968;146014;32095;240455;165560;406015
2010;13;España;13157;62061;236508;639191;127661;1078578;387606;1466184
2010;13;Holanda;821;1662;14907;47573;8551;73514;67727;141241
2010;13;Bélgica;421;847;8527;74230;18509;102534;24318;126852
2010;13;Alemania;3641;6732;95681;270953;56265;433272;103082;536354
2010;13;Francia;1509;6730;13080;40934;6975;69228;41675;110903
2010;13;Gran Bretaña;8703;6157;113120;469436;103575;700991;798310;1499301
2010;13;Irlanda;107;571;7336;17698;6360;32072;35776;67848
2010;13;Italia;927;2206;12858;39348;7237;62576;27835;90411
2010;13;Suecia;162;1061;9823;33067;2772;46885;74053;120938
2010;13;Noruega;80;1455;6834;12606;2205;23180;56247;79427
2010;13;Dinamarca;80;2941;6875;16865;1354;28115;50121;78236
2010;13;Finlandia;63;561;10625;18393;2352;31994;76131;108125
2010;13;Suiza;362;790;3150;11860;5676;21838;9224;31062
2010;13;Austria;133;438;2789;13969;3513;20842;9332;30174
2010;13;Rusia;1342;319;4291;18285;12916;37153;44839;81992
2010;13;Países del Este;447;2794;11621;24950;5985;45797;31916;77713
2010;13;Resto de Europa;305;1119;16276;40506;7779;65985;26226;92211
2010;13;Estados Unidos;95;595;1847;3562;2537;8636;4049;12685
2010;13;Resto de América;887;2494;4434;3312;1534;12661;6450;19111
2010;13;Resto del Mundo;491;1987;5001;28857;6022;42358;18199;60557
2010;13;TOTAL;33733;103520;585583;1825595;389778;2938209;1893116;4831325
2011;1;España;1051;5555;14036;34313;4783;59738;10171;69909
2011;1;Holanda;72;177;1480;3610;619;5958;4737;10695
2011;1;Bélgica;48;95;829;7504;1729;10205;2299;12504
2011;1;Alemania;243;879;8189;28848;4539;42698;9893;52591
2011;1;Francia;112;1088;1224;4624;902;7950;3498;11448
2011;1;Gran Bretaña;1152;625;9277;35333;10004;56391;53526;109917
2011;1;Irlanda;17;84;749;1566;647;3063;2695;5758
2011;1;Italia;157;246;1992;6382;1147;9924;2936;12860
2011;1;Suecia;46;96;2368;7029;641;10180;10082;20262
2011;1;Noruega;13;73;2070;2144;280;4580;8348;12928
2011;1;Dinamarca;24;40;1747;3000;175;4986;7004;11990
2011;1;Finlandia;12;53;2469;3747;369;6650;17267;23917
2011;1;Suiza;19;97;244;955;401;1716;806;2522
2011;1;Austria;18;60;319;1388;445;2230;1253;3483
2011;1;Rusia;153;61;439;1979;1044;3676;4082;7758
2011;1;Países del Este;42;231;781;2224;339;3617;2512;6129
2011;1;Resto de Europa;30;113;1114;2411;244;3912;1567;5479
2011;1;Estados Unidos;10;38;72;238;178;536;238;774
2011;1;Resto de América;66;193;234;221;77;791;294;1085
2011;1;Resto del Mundo;39;97;232;1285;402;2055;1496;3551
2011;1;TOTAL;3324;9901;49865;148801;28965;240856;144704;385560
2011;2;España;742;5729;14181;34417;5126;60195;11217;71412
2011;2;Holanda;38;223;1819;5149;881;8110;7777;15887
2011;2;Bélgica;29;123;611;7074;2050;9887;1981;11868
2011;2;Alemania;168;1008;8330;25647;7224;42377;10358;52735
2011;2;Francia;191;1623;2525;7250;1235;12824;5675;18499
2011;2;Gran Bretaña;1005;803;8827;37035;11112;58782;62929;121711
2011;2;Irlanda;6;147;349;1729;774;3005;2485;5490
2011;2;Italia;83;290;1077;6798;713;8961;2722;11683
2011;2;Suecia;13;125;2703;7290;676;10807;11438;22245
2011;2;Noruega;7;84;2343;2913;505;5852;9780;15632
2011;2;Dinamarca;18;87;2381;3774;332;6592;10327;16919
2011;2;Finlandia;14;51;2740;4359;587;7751;15369;23120
2011;2;Suiza;28;100;288;1176;606;2198;1398;3596
2011;2;Austria;22;89;347;1734;582;2774;775;3549
2011;2;Rusia;71;49;321;920;502;1863;2567;4430
2011;2;Países del Este;55;263;1055;2154;760;4287;1727;6014
2011;2;Resto de Europa;60;178;1497;3252;643;5630;2161;7791
2011;2;Estados Unidos;11;67;101;370;281;830;248;1078
2011;2;Resto de América;73;187;177;221;60;718;288;1006
2011;2;Resto del Mundo;43;197;307;685;306;1538;1426;2964
2011;2;TOTAL;2677;11423;51979;153947;34955;254981;162648;417629
2011;3;España;1148;6591;15131;37329;6045;66244;13189;79433
2011;3;Holanda;63;233;1978;5450;1210;8934;7590;16524
2011;3;Bélgica;30;111;770;7672;2355;10938;2018;12956
2011;3;Alemania;361;1045;9802;28104;7091;46403;11888;58291
2011;3;Francia;188;1850;2546;6899;756;12239;5527;17766
2011;3;Gran Bretaña;1330;725;11606;45386;10219;69266;64173;133439
2011;3;Irlanda;13;141;677;1614;640;3085;2953;6038
2011;3;Italia;86;310;1868;5381;769;8414;2338;10752
2011;3;Suecia;21;78;2260;7706;606;10671;15278;25949
2011;3;Noruega;17;53;1579;2922;541;5112;11005;16117
2011;3;Dinamarca;23;94;1850;3543;464;5974;11026;17000
2011;3;Finlandia;29;122;2457;4355;863;7826;16399;24225
2011;3;Suiza;25;65;362;1301;720;2473;612;3085
2011;3;Austria;27;56;325;1352;366;2126;629;2755
2011;3;Rusia;165;89;397;1560;1083;3294;4256;7550
2011;3;Países del Este;86;260;1206;2410;758;4720;2751;7471
2011;3;Resto de Europa;34;160;1708;3662;655;6219;2570;8789
2011;3;Estados Unidos;8;51;110;294;427;890;417;1307
2011;3;Resto de América;57;203;204;131;408;1003;400;1403
2011;3;Resto del Mundo;48;177;397;644;744;2010;1388;3398
2011;3;TOTAL;3759;12414;57233;167715;36720;277841;176407;454248
2011;4;España;1263;5182;18922;52786;7794;85947;33263;119210
2011;4;Holanda;81;157;1563;5312;863;7976;6457;14433
2011;4;Bélgica;16;66;612;8191;2336;11221;2126;13347
2011;4;Alemania;279;872;9501;26915;5644;43211;11583;54794
2011;4;Francia;185;1592;2826;9731;1221;15555;7616;23171
2011;4;Gran Bretaña;1405;857;11287;43064;13329;69942;75493;145435
2011;4;Irlanda;2;109;591;1341;669;2712;3267;5979
2011;4;Italia;97;259;1187;5247;1013;7803;2056;9859
2011;4;Suecia;5;23;1127;4508;477;6140;8668;14808
2011;4;Noruega;16;26;971;2299;306;3618;5806;9424
2011;4;Dinamarca;17;56;1459;2722;191;4445;7202;11647
2011;4;Finlandia;18;20;785;1310;277;2410;6746;9156
2011;4;Suiza;13;99;604;1526;813;3055;998;4053
2011;4;Austria;13;43;372;1687;445;2560;957;3517
2011;4;Rusia;205;97;474;3034;1573;5383;4055;9438
2011;4;Países del Este;55;300;1036;4843;664;6898;2898;9796
2011;4;Resto de Europa;25;138;1287;4186;987;6623;2344;8967
2011;4;Estados Unidos;27;54;161;442;350;1034;696;1730
2011;4;Resto de América;46;245;336;348;179;1154;525;1679
2011;4;Resto del Mundo;52;243;302;1989;527;3113;1043;4156
2011;4;TOTAL;3820;10438;55403;181481;39658;290800;183799;474599
2011;5;España;1336;5413;19942;51477;7633;85801;28988;114789
2011;5;Holanda;51;120;1227;3827;880;6105;4673;10778
2011;5;Bélgica;19;82;365;4584;1237;6287;1144;7431
2011;5;Alemania;167;434;6641;19758;3911;30911;5559;36470
2011;5;Francia;95;996;1646;4981;813;8531;3345;11876
2011;5;Gran Bretaña;968;407;8578;43518;9327;62798;60117;122915
2011;5;Irlanda;9;36;564;1544;498;2651;3092;5743
2011;5;Italia;48;211;973;4209;631;6072;1503;7575
2011;5;Suecia;7;9;139;187;62;404;597;1001
2011;5;Noruega;5;12;194;79;62;352;1398;1750
2011;5;Dinamarca;7;3;173;648;38;869;1686;2555
2011;5;Finlandia;0;26;93;124;14;257;934;1191
2011;5;Suiza;18;78;507;1065;706;2374;545;2919
2011;5;Austria;9;23;221;890;365;1508;475;1983
2011;5;Rusia;62;25;461;2446;1432;4426;4086;8512
2011;5;Países del Este;29;219;779;2151;683;3861;2319;6180
2011;5;Resto de Europa;20;173;971;2488;631;4283;1940;6223
2011;5;Estados Unidos;7;31;80;276;279;673;455;1128
2011;5;Resto de América;69;193;129;266;67;724;460;1184
2011;5;Resto del Mundo;41;163;492;3669;431;4796;1181;5977
2011;5;TOTAL;2967;8654;44175;148187;29700;233683;124497;358180
2011;6;España;1189;5663;18532;57405;8515;91304;32994;124298
2011;6;Holanda;12;81;729;3495;552;4869;3197;8066
2011;6;Bélgica;4;52;332;6614;1218;8220;1113;9333
2011;6;Alemania;109;340;7309;22203;4202;34163;6267;40430
2011;6;Francia;78;594;830;3150;767;5419;3262;8681
2011;6;Gran Bretaña;885;327;10142;39115;7552;58021;76431;134452
2011;6;Irlanda;2;17;628;1314;544;2505;4547;7052
2011;6;Italia;111;183;977;3452;404;5127;2162;7289
2011;6;Suecia;0;27;81;97;30;235;260;495
2011;6;Noruega;4;161;130;98;235;628;616;1244
2011;6;Dinamarca;5;227;130;268;100;730;944;1674
2011;6;Finlandia;3;16;20;91;14;144;92;236
2011;6;Suiza;25;37;277;977;560;1876;509;2385
2011;6;Austria;10;9;150;940;294;1403;327;1730
2011;6;Rusia;156;49;453;3540;1841;6039;4272;10311
2011;6;Países del Este;86;234;1018;2650;620;4608;2921;7529
2011;6;Resto de Europa;13;124;1759;5274;758;7928;2878;10806
2011;6;Estados Unidos;4;35;120;375;233;767;500;1267
2011;6;Resto de América;97;143;273;252;124;889;557;1446
2011;6;Resto del Mundo;55;103;232;3087;498;3975;1384;5359
2011;6;TOTAL;2848;8422;44122;154397;29061;238850;145233;384083
2011;7;España;1097;6094;20851;77365;12036;117443;52031;169474
2011;7;Holanda;28;70;2306;5779;639;8822;6748;15570
2011;7;Bélgica;13;82;700;8536;1602;10933;2619;13552
2011;7;Alemania;112;302;8818;22492;2637;34361;9012;43373
2011;7;Francia;126;522;1623;4618;859;7748;6137;13885
2011;7;Gran Bretaña;1168;524;13492;42501;11589;69274;88501;157775
2011;7;Irlanda;2;40;904;1397;552;2895;4909;7804
2011;7;Italia;85;202;1877;4171;435;6770;3285;10055
2011;7;Suecia;3;16;125;291;102;537;422;959
2011;7;Noruega;14;43;79;350;81;567;822;1389
2011;7;Dinamarca;3;288;238;714;108;1351;1564;2915
2011;7;Finlandia;2;32;11;48;1;94;80;174
2011;7;Suiza;16;18;596;1926;602;3158;1134;4292
2011;7;Austria;3;10;389;1997;288;2687;840;3527
2011;7;Rusia;309;88;719;4304;2410;7830;5038;12868
2011;7;Países del Este;75;248;1454;3698;692;6167;3012;9179
2011;7;Resto de Europa;25;118;1909;5792;920;8764;2993;11757
2011;7;Estados Unidos;16;27;154;288;323;808;453;1261
2011;7;Resto de América;89;182;309;359;158;1097;807;1904
2011;7;Resto del Mundo;66;169;368;4339;1427;6369;2223;8592
2011;7;TOTAL;3252;9075;56922;190965;37461;297675;192630;490305
2011;8;España;758;4403;20518;83580;14014;123273;55200;178473
2011;8;Holanda;20;102;2074;4709;662;7567;5661;13228
2011;8;Bélgica;11;58;619;7343;1141;9172;1949;11121
2011;8;Alemania;186;420;9003;21642;3076;34327;7545;41872
2011;8;Francia;138;747;1545;4260;1279;7969;5430;13399
2011;8;Gran Bretaña;864;608;14765;42582;8507;67326;86882;154208
2011;8;Irlanda;0;24;887;1233;367;2511;3794;6305
2011;8;Italia;93;411;3374;5748;903;10529;6825;17354
2011;8;Suecia;0;24;37;522;28;611;281;892
2011;8;Noruega;0;135;36;382;20;573;620;1193
2011;8;Dinamarca;3;321;182;454;69;1029;1053;2082
2011;8;Finlandia;0;10;8;18;0;36;36;72
2011;8;Suiza;6;36;426;1532;505;2505;384;2889
2011;8;Austria;3;29;258;1438;274;2002;324;2326
2011;8;Rusia;177;32;673;3491;2704;7077;3456;10533
2011;8;Países del Este;59;202;1227;2602;924;5014;2578;7592
2011;8;Resto de Europa;45;104;1772;6782;951;9654;2861;12515
2011;8;Estados Unidos;2;41;38;144;207;432;371;803
2011;8;Resto de América;83;155;391;1502;103;2234;718;2952
2011;8;Resto del Mundo;39;156;211;3139;1293;4838;2203;7041
2011;8;TOTAL;2487;8018;58044;193103;37027;298679;188171;486850
2011;9;España;1127;6115;16412;56767;10304;90725;32788;123513
2011;9;Holanda;14;97;1311;4245;769;6436;4364;10800
2011;9;Bélgica;24;73;720;7165;1337;9319;2068;11387
2011;9;Alemania;214;542;8623;25308;4241;38928;7575;46503
2011;9;Francia;108;517;1145;3316;401;5487;3652;9139
2011;9;Gran Bretaña;1034;459;14576;46513;10420;73002;81929;154931
2011;9;Irlanda;5;31;884;1368;646;2934;3591;6525
2011;9;Italia;118;257;1274;4628;482;6759;2341;9100
2011;9;Suecia;0;16;93;491;25;625;395;1020
2011;9;Noruega;5;185;50;317;56;613;773;1386
2011;9;Dinamarca;7;254;142;514;70;987;903;1890
2011;9;Finlandia;1;16;28;187;21;253;206;459
2011;9;Suiza;12;45;454;1236;546;2293;681;2974
2011;9;Austria;7;32;214;1343;262;1858;416;2274
2011;9;Rusia;159;61;865;3262;1943;6290;4066;10356
2011;9;Países del Este;139;312;1763;3348;866;6428;3350;9778
2011;9;Resto de Europa;35;74;2286;5520;713;8628;2711;11339
2011;9;Estados Unidos;10;25;56;135;188;414;264;678
2011;9;Resto de América;133;194;468;291;125;1211;626;1837
2011;9;Resto del Mundo;39;119;305;3040;1037;4540;802;5342
2011;9;TOTAL;3191;9424;51669;168994;34452;267730;153501;421231
2011;10;España;1205;4510;10737;45451;7268;69171;24975;94146
2011;10;Holanda;28;151;1975;5437;1111;8702;6864;15566
2011;10;Bélgica;11;154;732;6960;2036;9893;1953;11846
2011;10;Alemania;187;765;10373;26298;6180;43803;9920;53723
2011;10;Francia;134;722;1345;4763;820;7784;5251;13035
2011;10;Gran Bretaña;866;1438;15833;54193;14219;86549;78801;165350
2011;10;Irlanda;3;56;872;1777;849;3557;3725;7282
2011;10;Italia;113;238;1226;3155;605;5337;2380;7717
2011;10;Suecia;15;132;1252;3863;384;5646;7699;13345
2011;10;Noruega;15;167;1100;1814;587;3683;6755;10438
2011;10;Dinamarca;5;431;681;1670;201;2988;3770;6758
2011;10;Finlandia;28;56;1255;2784;321;4444;7597;12041
2011;10;Suiza;37;194;772;2555;1180;4738;1431;6169
2011;10;Austria;19;20;296;1303;450;2088;628;2716
2011;10;Rusia;147;56;803;2729;1766;5501;5065;10566
2011;10;Países del Este;119;258;1099;2946;898;5320;3721;9041
2011;10;Resto de Europa;55;141;1758;4054;650;6658;3429;10087
2011;10;Estados Unidos;0;50;85;205;187;527;326;853
2011;10;Resto de América;113;209;284;258;120;984;451;1435
2011;10;Resto del Mundo;54;196;316;3611;1187;5364;1377;6741
2011;10;TOTAL;3154;9944;52794;175826;41019;282737;176118;458855
2011;11;España;1107;5048;14481;37554;4005;62195;12868;75063
2011;11;Holanda;83;190;1448;4206;857;6784;4469;11253
2011;11;Bélgica;42;109;846;7563;1805;10365;2332;12697
2011;11;Alemania;309;991;7915;31686;7220;48121;10424;58545
2011;11;Francia;163;667;1368;2856;683;5737;3072;8809
2011;11;Gran Bretaña;799;2214;11586;41203;9197;64999;63934;128933
2011;11;Irlanda;11;103;660;1625;654;3053;2618;5671
2011;11;Italia;104;286;907;2646;586;4529;1419;5948
2011;11;Suecia;8;107;2443;7111;990;10659;16782;27441
2011;11;Noruega;22;57;1661;2623;951;5314;7580;12894
2011;11;Dinamarca;55;696;875;1920;249;3795;5736;9531
2011;11;Finlandia;18;64;2150;3537;861;6630;11013;17643
2011;11;Suiza;34;186;299;1570;881;2970;791;3761
2011;11;Austria;2;38;408;1954;495;2897;731;3628
2011;11;Rusia;116;105;634;2660;1250;4765;4165;8930
2011;11;Países del Este;85;259;1122;2731;640;4837;2696;7533
2011;11;Resto de Europa;35;197;1275;2995;712;5214;2247;7461
2011;11;Estados Unidos;8;42;148;245;210;653;213;866
2011;11;Resto de América;84;184;256;186;62;772;313;1085
2011;11;Resto del Mundo;47;267;290;2772;247;3623;1015;4638
2011;11;TOTAL;3132;11810;50772;159643;32555;257912;154418;412330
2011;12;España;1070;4415;13984;39922;8125;67516;15066;82582
2011;12;Holanda;65;151;1293;4178;500;6187;5144;11331
2011;12;Bélgica;41;144;725;7437;1499;9846;2871;12717
2011;12;Alemania;193;924;6505;27612;4443;39677;10280;49957
2011;12;Francia;171;937;1653;4249;841;7851;3850;11701
2011;12;Gran Bretaña;1253;621;11076;38980;10711;62641;66608;129249
2011;12;Irlanda;2;72;520;1133;494;2221;2215;4436
2011;12;Italia;74;316;1078;2667;381;4516;3015;7531
2011;12;Suecia;10;124;1755;6873;748;9510;17805;27315
2011;12;Noruega;10;130;1178;2056;453;3827;7240;11067
2011;12;Dinamarca;18;765;1182;1882;195;4042;6782;10824
2011;12;Finlandia;24;104;1754;3197;877;5956;12935;18891
2011;12;Suiza;32;82;269;1036;562;1981;753;2734
2011;12;Austria;10;53;364;1342;305;2074;754;2828
2011;12;Rusia;188;114;851;2947;1296;5396;5134;10530
2011;12;Países del Este;112;256;1236;2879;509;4992;2747;7739
2011;12;Resto de Europa;37;143;1399;3471;768;5818;2215;8033
2011;12;Estados Unidos;49;85;107;326;279;846;567;1413
2011;12;Resto de América;91;143;368;343;134;1079;589;1668
2011;12;Resto del Mundo;34;273;358;1176;392;2233;1554;3787
2011;12;TOTAL;3484;9852;47655;153706;33512;248209;168124;416333
2011;13;España;13093;64718;197727;608366;95648;979552;322750;1302302
2011;13;Holanda;555;1752;19203;55397;9543;86450;67681;154131
2011;13;Bélgica;288;1149;7861;86643;20345;116286;24473;140759
2011;13;Alemania;2528;8522;101009;306513;60408;478980;110304;589284
2011;13;Francia;1689;11855;20276;60697;10577;105094;56315;161409
2011;13;Gran Bretaña;12729;9608;141045;509423;126186;798991;859324;1658315
2011;13;Irlanda;72;860;8285;17641;7334;34192;39891;74083
2011;13;Italia;1169;3209;17810;54484;8069;84741;32982;117723
2011;13;Suecia;128;777;14383;45968;4769;66025;89707;155732
2011;13;Noruega;128;1126;11391;17997;4077;34719;60743;95462
2011;13;Dinamarca;185;3262;11040;21109;2192;37788;57997;95785
2011;13;Finlandia;149;570;13770;23757;4205;42451;88674;131125
2011;13;Suiza;265;1037;5098;16855;8082;31337;10042;41379
2011;13;Austria;143;462;3663;17368;4571;26207;8109;34316
2011;13;Rusia;1908;826;7090;32872;18844;61540;50242;111782
2011;13;Países del Este;942;3042;13776;34636;8353;60749;33232;93981
2011;13;Resto de Europa;414;1663;18735;49887;8632;79331;29916;109247
2011;13;Estados Unidos;152;546;1232;3338;3142;8410;4748;13158
2011;13;Resto de América;1001;2231;3429;4378;1617;12656;6028;18684
2011;13;Resto del Mundo;557;2160;3810;29436;8491;44454;17092;61546
2011;13;TOTAL;38095;119375;620633;1996765;415085;3189953;1970250;5160203
2012;1;España;963;4065;13130;34381;7032;59571;8790;68361
2012;1;Holanda;51;134;1564;4453;957;7159;4724;11883
2012;1;Bélgica;58;97;954;7505;1891;10505;2456;12961
2012;1;Alemania;213;565;7616;32506;6041;46941;9488;56429
2012;1;Francia;124;944;1063;4501;883;7515;2586;10101
2012;1;Gran Bretaña;1085;2121;9992;37087;10292;60577;50838;111415
2012;1;Irlanda;10;64;674;1923;852;3523;2241;5764
2012;1;Italia;103;252;1975;6115;1304;9749;2501;12250
2012;1;Suecia;24;167;2424;8612;1188;12415;16356;28771
2012;1;Noruega;29;108;1301;3172;905;5515;8561;14076
2012;1;Dinamarca;52;1055;1418;2876;435;5836;8177;14013
2012;1;Finlandia;20;74;1875;3669;733;6371;11000;17371
2012;1;Suiza;47;133;311;1034;750;2275;470;2745
2012;1;Austria;15;30;379;1557;504;2485;646;3131
2012;1;Rusia;306;114;736;3067;1942;6165;4351;10516
2012;1;Países del Este;91;265;1051;3479;543;5429;2479;7908
2012;1;Resto de Europa;32;178;1132;2803;640;4785;1895;6680
2012;1;Estados Unidos;16;48;96;255;230;645;253;898
2012;1;Resto de América;81;171;165;225;127;769;297;1066
2012;1;Resto del Mundo;24;207;361;2317;816;3725;1001;4726
2012;1;TOTAL;3344;10792;48217;161537;38065;261955;139110;401065
2012;2;España;1000;4789;15558;30730;6555;58632;11184;69816
2012;2;Holanda;90;159;1717;4953;1235;8154;5107;13261
2012;2;Bélgica;49;139;806;7017;2127;10138;2002;12140
2012;2;Alemania;341;909;9037;27882;6336;44505;8585;53090
2012;2;Francia;155;863;2170;5702;955;9845;4502;14347
2012;2;Gran Bretaña;1036;2042;10520;40122;12545;66265;54375;120640
2012;2;Irlanda;25;108;595;1480;802;3010;2211;5221
2012;2;Italia;83;301;1175;3550;703;5812;2018;7830
2012;2;Suecia;25;171;1815;7860;1168;11039;14431;25470
2012;2;Noruega;10;123;1493;3619;1002;6247;8736;14983
2012;2;Dinamarca;9;699;1421;4062;543;6734;8802;15536
2012;2;Finlandia;32;126;1759;4545;855;7317;9772;17089
2012;2;Suiza;33;114;477;1071;761;2456;536;2992
2012;2;Austria;48;67;448;1630;604;2797;719;3516
2012;2;Rusia;121;71;466;1247;752;2657;2924;5581
2012;2;Países del Este;88;180;977;2247;596;4088;1827;5915
2012;2;Resto de Europa;28;160;1521;2501;795;5005;2006;7011
2012;2;Estados Unidos;10;63;133;297;183;686;319;1005
2012;2;Resto de América;97;159;241;217;103;817;231;1048
2012;2;Resto del Mundo;29;177;261;2404;901;3772;570;4342
2012;2;TOTAL;3309;11420;52590;153136;39521;259976;140857;400833
2012;3;España;971;3067;16415;35001;7335;62789;16267;79056
2012;3;Holanda;63;164;1511;4331;1018;7087;5160;12247
2012;3;Bélgica;25;107;846;6692;1639;9309;2347;11656
2012;3;Alemania;279;784;9522;28143;6423;45151;10410;55561
2012;3;Francia;140;1199;2145;5633;941;10058;4433;14491
2012;3;Gran Bretaña;1457;1907;11886;47204;13853;76307;66261;142568
2012;3;Irlanda;4;64;540;1399;718;2725;2360;5085
2012;3;Italia;72;209;1025;3040;556;4902;1784;6686
2012;3;Suecia;14;91;2336;7931;1145;11517;13967;25484
2012;3;Noruega;28;52;1771;3370;698;5919;8547;14466
2012;3;Dinamarca;10;610;1649;3486;368;6123;8171;14294
2012;3;Finlandia;12;36;1929;4703;763;7443;10024;17467
2012;3;Suiza;27;126;332;967;685;2137;508;2645
2012;3;Austria;8;18;380;1445;478;2329;851;3180
2012;3;Rusia;201;48;616;2330;1389;4584;4754;9338
2012;3;Países del Este;64;264;1310;2796;541;4975;2830;7805
2012;3;Resto de Europa;19;150;1775;3271;643;5858;2533;8391
2012;3;Estados Unidos;6;42;130;254;224;656;394;1050
2012;3;Resto de América;113;119;286;266;120;904;353;1257
2012;3;Resto del Mundo;40;138;288;2391;899;3756;540;4296
2012;3;TOTAL;3553;9195;56692;164653;40436;274529;162494;437023
2012;4;España;957;5203;18239;46964;9509;80872;30410;111282
2012;4;Holanda;23;108;1274;5709;871;7985;4710;12695
2012;4;Bélgica;24;94;688;6798;1845;9449;1728;11177
2012;4;Alemania;140;616;7686;25960;5791;40193;8079;48272
2012;4;Francia;161;1372;2662;8602;1283;14080;6228;20308
2012;4;Gran Bretaña;1003;384;8472;43529;13966;67354;57163;124517
2012;4;Irlanda;1;46;495;1498;633;2673;2670;5343
2012;4;Italia;56;186;1033;2928;747;4950;1831;6781
2012;4;Suecia;3;108;1051;3428;646;5236;6902;12138
2012;4;Noruega;6;108;907;1778;481;3280;4042;7322
2012;4;Dinamarca;47;270;786;1871;235;3209;3165;6374
2012;4;Finlandia;5;35;751;1554;227;2572;3120;5692
2012;4;Suiza;19;120;458;1434;920;2951;850;3801
2012;4;Austria;16;40;280;1011;380;1727;574;2301
2012;4;Rusia;208;143;629;3192;2377;6549;4552;11101
2012;4;Países del Este;68;232;856;3571;583;5310;2545;7855
2012;4;Resto de Europa;7;133;1285;2861;743;5029;2327;7356
2012;4;Estados Unidos;3;60;149;430;578;1220;452;1672
2012;4;Resto de América;90;191;299;362;112;1054;437;1491
2012;4;Resto del Mundo;39;155;234;1998;981;3407;659;4066
2012;4;TOTAL;2876;9604;48234;165478;42908;269100;142444;411544
2012;5;España;934;4943;17762;47115;7853;78607;23638;102245
2012;5;Holanda;20;61;841;4002;736;5660;4107;9767
2012;5;Bélgica;51;84;538;5673;1356;7702;1234;8936
2012;5;Alemania;105;322;6233;21611;4600;32871;6176;39047
2012;5;Francia;70;771;2125;5422;917;9305;2967;12272
2012;5;Gran Bretaña;764;239;7722;44243;11483;64451;55429;119880
2012;5;Irlanda;4;36;548;1584;672;2844;3072;5916
2012;5;Italia;70;148;862;2378;1036;4494;1371;5865
2012;5;Suecia;0;22;183;161;30;396;488;884
2012;5;Noruega;0;64;105;98;77;344;378;722
2012;5;Dinamarca;2;184;453;548;59;1246;1238;2484
2012;5;Finlandia;0;30;92;208;30;360;435;795
2012;5;Suiza;15;55;271;924;831;2096;733;2829
2012;5;Austria;12;24;209;836;373;1454;335;1789
2012;5;Rusia;165;41;434;3224;2173;6037;4254;10291
2012;5;Países del Este;29;186;1266;8542;732;10755;3016;13771
2012;5;Resto de Europa;22;85;1103;2996;774;4980;2510;7490
2012;5;Estados Unidos;13;35;94;209;677;1028;343;1371
2012;5;Resto de América;68;152;277;331;218;1046;437;1483
2012;5;Resto del Mundo;39;150;258;2477;744;3668;1821;5489
2012;5;TOTAL;2383;7632;41376;152582;35371;239344;113982;353326
2012;6;España;879;4262;21201;57155;11598;95095;32991;128086
2012;6;Holanda;6;39;967;3812;467;5291;3431;8722
2012;6;Bélgica;19;38;780;5759;1090;7686;1477;9163
2012;6;Alemania;92;240;5892;22375;4399;32998;5544;38542
2012;6;Francia;54;535;1038;3351;634;5612;2941;8553
2012;6;Gran Bretaña;1158;318;11678;44562;12359;70075;67482;137557
2012;6;Irlanda;7;29;750;1549;527;2862;4533;7395
2012;6;Italia;70;150;1089;2418;422;4149;1810;5959
2012;6;Suecia;0;8;185;261;35;489;759;1248
2012;6;Noruega;3;82;288;96;48;517;698;1215
2012;6;Dinamarca;2;250;332;492;46;1122;1028;2150
2012;6;Finlandia;3;3;37;30;18;91;153;244
2012;6;Suiza;18;48;376;1135;644;2221;563;2784
2012;6;Austria;8;3;356;1269;434;2070;313;2383
2012;6;Rusia;315;70;563;5145;2538;8631;6653;15284
2012;6;Países del Este;45;176;1290;3981;530;6022;3751;9773
2012;6;Resto de Europa;4;60;1506;4330;897;6797;2182;8979
2012;6;Estados Unidos;21;37;128;270;336;792;557;1349
2012;6;Resto de América;117;128;372;283;154;1054;530;1584
2012;6;Resto del Mundo;65;92;319;2922;864;4262;804;5066
2012;6;TOTAL;2886;6568;49147;161195;38040;257836;138200;396036
2012;7;España;791;4596;21411;62596;13077;102471;39703;142174
2012;7;Holanda;21;70;2239;6905;1029;10264;7361;17625
2012;7;Bélgica;41;52;829;6590;2196;9708;2497;12205
2012;7;Alemania;121;298;7360;22170;3924;33873;7353;41226
2012;7;Francia;124;629;1568;4376;1021;7718;4451;12169
2012;7;Gran Bretaña;1104;244;11808;42996;11776;67928;70502;138430
2012;7;Irlanda;6;8;721;1234;537;2506;4034;6540
2012;7;Italia;50;167;913;3935;516;5581;2754;8335
2012;7;Suecia;0;2;439;396;73;910;698;1608
2012;7;Noruega;0;6;333;281;178;798;1428;2226
2012;7;Dinamarca;0;7;564;516;120;1207;2462;3669
2012;7;Finlandia;0;5;42;27;5;79;60;139
2012;7;Suiza;9;63;465;1928;881;3346;1318;4664
2012;7;Austria;4;17;267;1736;358;2382;578;2960
2012;7;Rusia;246;43;939;4382;3685;9295;4986;14281
2012;7;Países del Este;30;196;1578;4217;1410;7431;3457;10888
2012;7;Resto de Europa;13;67;1495;4609;1368;7552;2808;10360
2012;7;Estados Unidos;9;22;149;229;412;821;466;1287
2012;7;Resto de América;79;124;413;359;173;1148;531;1679
2012;7;Resto del Mundo;36;94;326;2345;750;3551;837;4388
2012;7;TOTAL;2684;6710;53859;171827;43489;278569;158284;436853
2012;8;España;725;4242;22931;68988;17382;114268;45521;159789
2012;8;Holanda;16;44;2028;5649;480;8217;6700;14917
2012;8;Bélgica;10;50;861;7376;1477;9774;1960;11734
2012;8;Alemania;210;255;7561;22467;3188;33681;8192;41873
2012;8;Francia;102;583;2055;5817;1492;10049;4847;14896
2012;8;Gran Bretaña;905;280;13255;40363;10798;65601;74263;139864
2012;8;Irlanda;6;28;796;1228;446;2504;3181;5685
2012;8;Italia;165;531;2959;5404;826;9885;5600;15485
2012;8;Suecia;4;29;143;638;19;833;615;1448
2012;8;Noruega;3;70;74;424;44;615;609;1224
2012;8;Dinamarca;0;232;261;474;64;1031;652;1683
2012;8;Finlandia;6;3;38;30;8;85;173;258
2012;8;Suiza;15;11;431;1353;418;2228;753;2981
2012;8;Austria;8;12;347;1716;291;2374;511;2885
2012;8;Rusia;262;55;1213;4711;4032;10273;5484;15757
2012;8;Países del Este;41;264;1206;3859;1193;6563;3973;10536
2012;8;Resto de Europa;26;103;2002;7733;1430;11294;2835;14129
2012;8;Estados Unidos;12;7;75;171;249;514;436;950
2012;8;Resto de América;91;145;444;357;111;1148;686;1834
2012;8;Resto del Mundo;33;107;271;2156;890;3457;1166;4623
2012;8;TOTAL;2640;7051;58951;180914;44838;294394;168157;462551
2012;9;España;884;4299;13768;52947;11129;83027;28309;111336
2012;9;Holanda;12;83;1187;4043;779;6104;4604;10708
2012;9;Bélgica;12;51;980;6949;1571;9563;1525;11088
2012;9;Alemania;143;462;6934;24321;6214;38074;7643;45717
2012;9;Francia;73;723;1339;3800;757;6692;2461;9153
2012;9;Gran Bretaña;839;254;14094;43770;11827;70784;63547;134331
2012;9;Irlanda;5;41;780;1291;700;2817;3404;6221
2012;9;Italia;97;176;1173;2979;484;4909;2123;7032
2012;9;Suecia;5;19;147;557;65;793;761;1554
2012;9;Noruega;6;109;148;399;127;789;1205;1994
2012;9;Dinamarca;1;253;243;563;93;1153;817;1970
2012;9;Finlandia;5;6;48;126;5;190;392;582
2012;9;Suiza;19;50;518;1622;1021;3230;1017;4247
2012;9;Austria;9;14;332;1345;377;2077;473;2550
2012;9;Rusia;185;84;1087;3661;2519;7536;4620;12156
2012;9;Países del Este;48;275;1000;4628;866;6817;3644;10461
2012;9;Resto de Europa;25;94;1968;4363;743;7193;2221;9414
2012;9;Estados Unidos;22;12;71;188;285;578;298;876
2012;9;Resto de América;72;189;373;307;120;1061;521;1582
2012;9;Resto del Mundo;32;88;225;2520;1173;4038;615;4653
2012;9;TOTAL;2494;7282;46415;160379;40855;257425;130200;387625
2012;10;España;1125;4167;13562;38731;8419;66004;18829;84833
2012;10;Holanda;50;141;1550;5884;1118;8743;6042;14785
2012;10;Bélgica;19;102;863;7058;2554;10596;1902;12498
2012;10;Alemania;171;626;9505;22685;6611;39598;8472;48070
2012;10;Francia;78;757;1251;4402;890;7378;3097;10475
2012;10;Gran Bretaña;977;325;13830;56260;16774;88166;64432;152598
2012;10;Irlanda;5;30;847;2322;743;3947;2152;6099
2012;10;Italia;48;218;1543;3458;373;5640;1596;7236
2012;10;Suecia;8;106;1050;3710;947;5821;8538;14359
2012;10;Noruega;18;103;963;2068;497;3649;5899;9548
2012;10;Dinamarca;8;530;695;1911;266;3410;3962;7372
2012;10;Finlandia;5;7;1071;2951;399;4433;6327;10760
2012;10;Suiza;35;228;763;2275;1497;4798;1533;6331
2012;10;Austria;14;41;324;1076;633;2088;693;2781
2012;10;Rusia;185;97;1242;3190;2272;6986;5534;12520
2012;10;Países del Este;13;199;1326;4336;554;6428;3787;10215
2012;10;Resto de Europa;45;112;1927;3890;705;6679;2288;8967
2012;10;Estados Unidos;0;18;96;296;428;838;213;1051
2012;10;Resto de América;57;137;392;201;116;903;380;1283
2012;10;Resto del Mundo;84;110;205;1804;629;2832;450;3282
2012;10;TOTAL;2945;8054;53005;168508;46425;278937;146126;425063
2012;11;España;1055;3988;10573;28199;6726;50541;11200;61741
2012;11;Holanda;78;158;1444;4498;868;7046;4972;12018
2012;11;Bélgica;44;103;707;6641;2021;9516;2603;12119
2012;11;Alemania;224;748;8669;28277;7610;45528;8890;54418
2012;11;Francia;164;638;1117;3165;800;5884;3205;9089
2012;11;Gran Bretaña;1007;983;11838;43465;12487;69780;57833;127613
2012;11;Irlanda;11;93;675;1610;697;3086;1940;5026
2012;11;Italia;104;222;967;2374;474;4141;1704;5845
2012;11;Suecia;26;172;2766;7624;1501;12089;12617;24706
2012;11;Noruega;24;159;1628;3891;897;6599;10405;17004
2012;11;Dinamarca;46;539;1005;2725;402;4717;5474;10191
2012;11;Finlandia;12;46;2083;4856;921;7918;9627;17545
2012;11;Suiza;52;137;502;1673;1019;3383;978;4361
2012;11;Austria;15;37;389;1329;552;2322;786;3108
2012;11;Rusia;366;105;1066;3541;2260;7338;5854;13192
2012;11;Países del Este;29;207;797;3650;528;5211;2856;8067
2012;11;Resto de Europa;39;74;1500;2693;681;4987;1558;6545
2012;11;Estados Unidos;20;26;117;190;211;564;199;763
2012;11;Resto de América;72;77;314;133;91;687;219;906
2012;11;Resto del Mundo;44;152;315;944;705;2160;568;2728
2012;11;TOTAL;3432;8664;48472;151478;41451;253497;143488;396985
2012;12;España;1065;3062;9830;31556;8374;53887;12402;66289
2012;12;Holanda;40;155;1446;4433;1056;7130;5662;12792
2012;12;Bélgica;37;96;756;7273;2239;10401;2666;13067
2012;12;Alemania;263;689;7369;24256;6625;39202;9169;48371
2012;12;Francia;119;1197;1176;3762;857;7111;3008;10119
2012;12;Gran Bretaña;800;771;10195;39521;13342;64629;54671;119300
2012;12;Irlanda;8;46;620;1369;530;2573;1803;4376
2012;12;Italia;107;196;1133;3110;623;5169;2436;7605
2012;12;Suecia;23;94;2764;8402;1585;12868;14091;26959
2012;12;Noruega;9;1194;1519;3975;535;7232;8698;15930
2012;12;Dinamarca;17;48;1077;2844;361;4347;6432;10779
2012;12;Finlandia;24;52;1459;4340;869;6744;11381;18125
2012;12;Suiza;31;157;385;1317;856;2746;833;3579
2012;12;Austria;6;46;304;1374;471;2201;889;3090
2012;12;Rusia;223;79;1019;3181;1877;6379;3858;10237
2012;12;Países del Este;20;255;692;3649;666;5282;2481;7763
2012;12;Resto de Europa;62;100;1211;2522;725;4620;1864;6484
2012;12;Estados Unidos;10;24;171;371;299;875;300;1175
2012;12;Resto de América;98;130;305;282;80;895;499;1394
2012;12;Resto del Mundo;52;206;312;1998;1057;3625;854;4479
2012;12;TOTAL;3014;8597;43743;149535;43027;247916;143997;391913
2012;13;España;11349;50683;194380;534363;114989;905764;279244;1185008
2012;13;Holanda;470;1316;17768;58672;10614;88840;62580;151420
2012;13;Bélgica;389;1013;9608;81331;22006;114347;24397;138744
2012;13;Alemania;2302;6514;93384;302653;67762;472615;98001;570616
2012;13;Francia;1364;10211;19709;58533;11430;101247;44726;145973
2012;13;Gran Bretaña;12135;9868;135290;523122;151502;831917;736796;1568713
2012;13;Irlanda;92;593;8041;18487;7857;35070;33601;68671
2012;13;Italia;1025;2756;15847;41689;8064;69381;27528;96909
2012;13;Suecia;132;989;15303;49580;8402;74406;90223;164629
2012;13;Noruega;136;2178;10530;23171;5489;41504;59206;100710
2012;13;Dinamarca;194;4677;9904;22368;2992;40135;50380;90515
2012;13;Finlandia;124;423;11184;27039;4833;43603;62464;106067
2012;13;Suiza;320;1242;5289;16733;10283;33867;10092;43959
2012;13;Austria;163;349;4015;16324;5455;26306;7368;33674
2012;13;Rusia;2783;950;10010;40871;27816;82430;57824;140254
2012;13;Países del Este;566;2699;13349;48955;8742;74311;36646;110957
2012;13;Resto de Europa;322;1316;18425;44572;10144;74779;27027;101806
2012;13;Estados Unidos;142;394;1409;3160;4112;9217;4230;13447
2012;13;Resto de América;1035;1722;3881;3323;1525;11486;5121;16607
2012;13;Resto del Mundo;517;1676;3375;26276;10409;42253;9885;52138
2012;13;TOTAL;35560;101569;600701;1941222;494426;3173478;1727339;4900817
2013;1;España;1290;2992;13068;28945;6547;52842;9376;62218
2013;1;Holanda;78;216;1409;4761;985;7449;5303;12752
2013;1;Bélgica;69;136;1010;7272;1645;10132;2426;12558
2013;1;Alemania;364;647;8018;26752;5241;41022;8766;49788
2013;1;Francia;217;792;952;4227;1171;7359;3378;10737
2013;1;Gran Bretaña;867;775;10827;38128;12787;63384;49857;113241
2013;1;Irlanda;11;104;746;1658;782;3301;1985;5286
2013;1;Italia;141;218;1604;5193;1037;8193;2313;10506
2013;1;Suecia;21;138;2322;7522;1491;11494;14946;26440
2013;1;Noruega;23;1409;1813;3065;867;7177;9738;16915
2013;1;Dinamarca;18;704;1329;2809;466;5326;6539;11865
2013;1;Finlandia;12;65;2074;3879;912;6942;10471;17413
2013;1;Suiza;44;62;441;1028;812;2387;895;3282
2013;1;Austria;24;39;366;1428;316;2173;670;2843
2013;1;Rusia;225;132;1114;3786;2448;7705;4929;12634
2013;1;Países del Este;37;180;785;2614;586;4202;2334;6536
2013;1;Resto de Europa;92;181;1522;2763;542;5100;2016;7116
2013;1;Estados Unidos;7;43;72;240;186;548;227;775
2013;1;Resto de América;98;120;244;196;111;769;295;1064
2013;1;Resto del Mundo;47;170;259;1837;1119;3432;554;3986
2013;1;TOTAL;3685;9123;49975;148103;40051;250937;137018;387955
2013;2;España;1459;3229;13194;29929;6670;54481;10723;65204
2013;2;Holanda;75;200;1635;4964;1400;8274;6290;14564
2013;2;Bélgica;33;101;780;6138;2062;9114;2050;11164
2013;2;Alemania;355;718;7637;23920;6696;39326;7498;46824
2013;2;Francia;208;965;1291;4323;1205;7992;3458;11450
2013;2;Gran Bretaña;1013;639;10000;35454;13751;60857;49966;110823
2013;2;Irlanda;24;123;745;1506;897;3295;2150;5445
2013;2;Italia;147;194;1007;3662;671;5681;1982;7663
2013;2;Suecia;27;154;2346;7524;1532;11583;13860;25443
2013;2;Noruega;19;1561;1882;3620;1036;8118;10277;18395
2013;2;Dinamarca;29;611;1508;3312;601;6061;6222;12283
2013;2;Finlandia;18;30;2102;4178;985;7313;10799;18112
2013;2;Suiza;41;136;629;1252;891;2949;694;3643
2013;2;Austria;22;38;355;1459;579;2453;833;3286
2013;2;Rusia;205;62;784;2339;1009;4399;3460;7859
2013;2;Países del Este;38;223;1022;1991;783;4057;2191;6248
2013;2;Resto de Europa;50;104;1333;2393;774;4654;1773;6427
2013;2;Estados Unidos;17;25;104;257;251;654;221;875
2013;2;Resto de América;75;111;240;198;117;741;293;1034
2013;2;Resto del Mundo;32;174;245;1965;1037;3453;489;3942
2013;2;TOTAL;3887;9398;48839;140384;42947;245455;135229;380684
2013;3;España;1381;4408;15655;42777;10436;74657;24960;99617
2013;3;Holanda;79;219;1429;5183;1206;8116;5889;14005
2013;3;Bélgica;46;119;910;6615;2512;10202;2635;12837
2013;3;Alemania;415;847;8498;25921;7868;43549;11551;55100
2013;3;Francia;259;1479;1744;6547;1414;11443;4457;15900
2013;3;Gran Bretaña;1131;638;12097;45989;15475;75330;60939;136269
2013;3;Irlanda;28;61;976;1899;914;3878;2413;6291
2013;3;Italia;98;159;1121;2997;509;4884;1460;6344
2013;3;Suecia;24;147;2768;8750;1500;13189;15097;28286
2013;3;Noruega;16;241;1881;4456;925;7519;9968;17487
2013;3;Dinamarca;42;684;1680;3697;559;6662;6352;13014
2013;3;Finlandia;22;23;2686;4885;767;8383;10304;18687
2013;3;Suiza;30;97;448;1233;957;2765;715;3480
2013;3;Austria;18;44;372;1285;589;2308;820;3128
2013;3;Rusia;254;85;924;3971;2141;7375;4839;12214
2013;3;Países del Este;41;164;691;3251;823;4970;2658;7628
2013;3;Resto de Europa;103;131;1981;4108;932;7255;2152;9407
2013;3;Estados Unidos;31;35;129;419;373;987;430;1417
2013;3;Resto de América;60;94;258;185;124;721;395;1116
2013;3;Resto del Mundo;58;156;259;1964;1206;3643;370;4013
2013;3;TOTAL;4136;9831;56507;176132;51230;297836;168404;466240
2013;4;España;1309;3280;14088;36657;6696;62030;20479;82509
2013;4;Holanda;50;101;1312;5679;1213;8355;5934;14289
2013;4;Bélgica;61;83;674;6980;2631;10429;1584;12013
2013;4;Alemania;267;460;6291;20656;5678;33352;6834;40186
2013;4;Francia;271;1225;1950;7806;1228;12480;3918;16398
2013;4;Gran Bretaña;50;403;11831;44736;17544;74564;58675;133239
2013;4;Irlanda;16;50;704;1591;906;3267;2852;6119
2013;4;Italia;131;162;1190;2753;662;4898;1707;6605
2013;4;Suecia;20;49;928;3242;700;4939;6759;11698
2013;4;Noruega;12;106;645;1168;246;2177;2852;5029
2013;4;Dinamarca;5;307;558;1848;253;2971;3141;6112
2013;4;Finlandia;3;16;992;1856;313;3180;3542;6722
2013;4;Suiza;60;90;507;1636;1039;3332;1137;4469
2013;4;Austria;29;39;228;907;374;1577;475;2052
2013;4;Rusia;54;158;1364;4238;3362;9176;5384;14560
2013;4;Países del Este;28;247;890;3151;1265;5581;2762;8343
2013;4;Resto de Europa;69;82;1641;3013;722;5527;1987;7514
2013;4;Estados Unidos;15;37;109;315;737;1213;523;1736
2013;4;Resto de América;84;80;228;174;251;817;330;1147
2013;4;Resto del Mundo;58;103;191;2110;1100;3562;482;4044
2013;4;TOTAL;2592;7078;46321;150516;46920;253427;131357;384784
2013;5;España;1225;3905;14668;45788;9896;75482;26049;101531
2013;5;Holanda;20;52;970;4440;757;6239;4372;10611
2013;5;Bélgica;22;77;633;6388;1563;8683;1467;10150
2013;5;Alemania;189;379;6295;19796;4908;31567;6656;38223
2013;5;Francia;145;836;1129;6451;1095;9656;3391;13047
2013;5;Gran Bretaña;999;518;10303;45859;13806;71485;62748;134233
2013;5;Irlanda;4;39;695;1750;479;2967;2649;5616
2013;5;Italia;77;150;816;2017;420;3480;1491;4971
2013;5;Suecia;4;111;40;169;77;401;761;1162
2013;5;Noruega;3;37;168;160;102;470;1216;1686
2013;5;Dinamarca;3;224;223;539;36;1025;937;1962
2013;5;Finlandia;0;5;165;413;8;591;432;1023
2013;5;Suiza;16;40;248;1018;835;2157;483;2640
2013;5;Austria;15;20;166;865;330;1396;353;1749
2013;5;Rusia;310;211;1372;6143;3170;11206;5249;16455
2013;5;Países del Este;18;297;605;3182;877;4979;3859;8838
2013;5;Resto de Europa;24;77;1409;3506;846;5862;2226;8088
2013;5;Estados Unidos;3;13;89;223;484;812;580;1392
2013;5;Resto de América;97;92;274;233;183;879;374;1253
2013;5;Resto del Mundo;29;147;194;3108;1106;4584;669;5253
2013;5;TOTAL;3203;7230;40462;152048;40978;243921;125962;369883
2013;6;España;1310;4277;19652;52257;10629;88125;35395;123520
2013;6;Holanda;15;43;933;3567;592;5150;3424;8574
2013;6;Bélgica;6;42;645;6532;1386;8611;1386;9997
2013;6;Alemania;74;320;6404;19411;4230;30439;5444;35883
2013;6;Francia;128;665;1347;5128;702;7970;2607;10577
2013;6;Gran Bretaña;832;610;12622;44779;11870;70713;63084;133797
2013;6;Irlanda;3;31;937;1780;487;3238;4714;7952
2013;6;Italia;54;133;1044;2203;492;3926;1700;5626
2013;6;Suecia;4;158;158;271;68;659;813;1472
2013;6;Noruega;1;58;229;394;84;766;889;1655
2013;6;Dinamarca;1;204;207;565;21;998;1050;2048
2013;6;Finlandia;0;1;52;105;27;185;217;402
2013;6;Suiza;10;57;354;969;791;2181;498;2679
2013;6;Austria;13;23;212;1262;365;1875;351;2226
2013;6;Rusia;157;195;1661;6691;3692;12396;6303;18699
2013;6;Países del Este;13;220;882;4048;1130;6293;3224;9517
2013;6;Resto de Europa;30;67;1356;4482;778;6713;1903;8616
2013;6;Estados Unidos;3;31;79;207;248;568;496;1064
2013;6;Resto de América;67;117;281;201;158;824;460;1284
2013;6;Resto del Mundo;47;142;270;2913;521;3893;760;4653
2013;6;TOTAL;2768;7394;49325;157765;38271;255523;134718;390241
2013;7;España;1421;4686;14680;61250;10829;92866;36239;129105
2013;7;Holanda;34;47;1390;5331;916;7718;7658;15376
2013;7;Bélgica;42;50;531;6217;1912;8752;2261;11013
2013;7;Alemania;125;319;6770;20261;3746;31221;7791;39012
2013;7;Francia;165;547;1139;5120;989;7960;3795;11755
2013;7;Gran Bretaña;683;444;11840;43018;12288;68273;69686;137959
2013;7;Irlanda;2;29;840;1621;318;2810;4123;6933
2013;7;Italia;76;142;1367;2517;322;4424;2149;6573
2013;7;Suecia;2;206;335;711;80;1334;865;2199
2013;7;Noruega;7;37;528;1004;203;1779;2207;3986
2013;7;Dinamarca;1;294;647;993;117;2052;1824;3876
2013;7;Finlandia;0;10;12;40;18;80;123;203
2013;7;Suiza;39;55;632;1889;1145;3760;1212;4972
2013;7;Austria;4;19;324;1768;468;2583;651;3234
2013;7;Rusia;203;129;1754;7250;3979;13315;6373;19688
2013;7;Países del Este;21;252;1049;4099;1108;6529;3737;10266
2013;7;Resto de Europa;98;62;1314;6740;1229;9443;1959;11402
2013;7;Estados Unidos;12;29;93;279;429;842;412;1254
2013;7;Resto de América;126;113;273;296;206;1014;426;1440
2013;7;Resto del Mundo;40;123;327;2744;788;4022;681;4703
2013;7;TOTAL;3101;7593;45845;173148;41090;270777;154172;424949
2013;8;España;1402;3860;19360;69971;14414;109007;49613;158620
2013;8;Holanda;13;41;1677;4632;614;6977;6439;13416
2013;8;Bélgica;35;84;633;6445;1364;8561;1754;10315
2013;8;Alemania;159;286;8786;19703;4382;33316;8786;42102
2013;8;Francia;182;728;1659;7779;1346;11694;5493;17187
2013;8;Gran Bretaña;933;555;10580;50036;12585;74689;71832;146521
2013;8;Irlanda;1;21;734;1627;331;2714;3705;6419
2013;8;Italia;133;495;2894;4625;761;8908;4980;13888
2013;8;Suecia;4;15;218;590;31;858;713;1571
2013;8;Noruega;4;34;310;447;57;852;763;1615
2013;8;Dinamarca;6;261;411;450;28;1156;935;2091
2013;8;Finlandia;0;0;19;43;8;70;175;245
2013;8;Suiza;2;47;365;1088;647;2149;729;2878
2013;8;Austria;5;29;327;1565;534;2460;600;3060
2013;8;Rusia;165;146;2081;6952;3673;13017;6631;19648
2013;8;Países del Este;30;255;1166;3932;1045;6428;4513;10941
2013;8;Resto de Europa;40;92;1538;5921;1108;8699;2245;10944
2013;8;Estados Unidos;17;10;69;179;286;561;361;922
2013;8;Resto de América;56;104;363;208;167;898;553;1451
2013;8;Resto del Mundo;45;100;351;3509;607;4612;716;5328
2013;8;TOTAL;3232;7163;53541;189702;43988;297626;171536;469162
2013;9;España;1270;4288;11626;48298;9894;75376;30696;106072
2013;9;Holanda;33;92;1018;4754;786;6683;4160;10843
2013;9;Bélgica;41;91;741;6156;1636;8665;1393;10058
2013;9;Alemania;151;440;8275;22278;5722;36866;7852;44718
2013;9;Francia;149;498;1148;4629;598;7022;3452;10474
2013;9;Gran Bretaña;495;298;10671;46509;12397;70370;64923;135293
2013;9;Irlanda;2;36;855;1849;365;3107;3231;6338
2013;9;Italia;141;278;1566;3818;387;6190;2390;8580
2013;9;Suecia;7;19;144;539;31;740;801;1541
2013;9;Noruega;5;66;322;345;175;913;855;1768
2013;9;Dinamarca;3;330;204;569;35;1141;930;2071
2013;9;Finlandia;14;5;54;144;12;229;191;420
2013;9;Suiza;17;64;468;1539;1070;3158;1086;4244
2013;9;Austria;0;26;334;1694;388;2442;456;2898
2013;9;Rusia;131;148;2404;6038;2739;11460;6268;17728
2013;9;Países del Este;38;205;1181;3823;634;5881;4316;10197
2013;9;Resto de Europa;63;126;1622;5829;814;8454;2160;10614
2013;9;Estados Unidos;22;16;91;283;466;878;186;1064
2013;9;Resto de América;97;112;323;285;152;969;536;1505
2013;9;Resto del Mundo;53;107;233;2858;553;3804;690;4494
2013;9;TOTAL;2732;7245;43280;162237;38854;254348;136572;390920
2013;10;España;1366;4291;11888;38040;6832;62417;21776;84193
2013;10;Holanda;18;116;1278;4964;1314;7690;5528;13218
2013;10;Bélgica;49;89;646;5970;2395;9149;1551;10700
2013;10;Alemania;162;591;8571;22174;7453;38951;9178;48129
2013;10;Francia;184;694;1187;6009;945;9019;4028;13047
2013;10;Gran Bretaña;1165;533;12549;58609;16266;89122;62773;151895
2013;10;Irlanda;8;76;902;2390;345;3721;2779;6500
2013;10;Italia;121;241;1696;2777;357;5192;2038;7230
2013;10;Suecia;13;117;1883;5117;759;7889;9867;17756
2013;10;Noruega;3;217;1834;2844;360;5258;7097;12355
2013;10;Dinamarca;6;451;1075;2460;207;4199;4300;8499
2013;10;Finlandia;5;16;1074;2630;319;4044;5148;9192
2013;10;Suiza;32;134;734;2707;1751;5358;1489;6847
2013;10;Austria;5;24;378;1207;561;2175;515;2690
2013;10;Rusia;171;139;2348;5833;1829;10320;6732;17052
2013;10;Países del Este;56;218;1272;3865;431;5842;3612;9454
2013;10;Resto de Europa;40;109;1793;5324;767;8033;2630;10663
2013;10;Estados Unidos;17;18;168;217;320;740;164;904
2013;10;Resto de América;91;138;280;196;100;805;462;1267
2013;10;Resto del Mundo;26;118;250;3101;394;3889;529;4418
2013;10;TOTAL;3538;8330;51806;176434;43705;283813;152196;436009
2013;11;España;1907;3525;14769;35065;6438;61704;14581;76285
2013;11;Holanda;88;236;1190;4869;876;7259;4458;11717
2013;11;Bélgica;57;142;853;6732;2151;9935;2026;11961
2013;11;Alemania;539;1087;9211;32490;8745;52072;14314;66386
2013;11;Francia;312;753;685;3343;875;5968;2649;8617
2013;11;Gran Bretaña;1084;890;11039;46328;13496;72837;53358;126195
2013;11;Irlanda;7;77;553;1900;527;3064;1970;5034
2013;11;Italia;225;285;1490;2805;551;5356;2014;7370
2013;11;Suecia;28;639;3144;9966;2056;15833;14909;30742
2013;11;Noruega;31;759;2589;4974;1277;9630;12532;22162
2013;11;Dinamarca;47;326;1396;3022;327;5118;6767;11885
2013;11;Finlandia;26;91;2257;4944;813;8131;11196;19327
2013;11;Suiza;85;159;516;2142;1454;4356;1199;5555
2013;11;Austria;21;59;422;1913;825;3240;982;4222
2013;11;Rusia;301;121;1561;5205;2125;9313;6208;15521
2013;11;Países del Este;101;321;975;3895;501;5793;3025;8818
2013;11;Resto de Europa;86;236;1500;3727;670;6219;2288;8507
2013;11;Estados Unidos;17;31;124;370;355;897;253;1150
2013;11;Resto de América;117;160;327;172;147;923;368;1291
2013;11;Resto del Mundo;54;161;317;2414;671;3617;463;4080
2013;11;TOTAL;5133;10058;54918;176276;44880;291265;155560;446825
2013;12;España;1769;3102;12919;35133;7602;60525;12523;73048
2013;12;Holanda;56;197;1265;4917;1013;7448;4766;12214
2013;12;Bélgica;58;108;864;7330;2343;10703;2644;13347
2013;12;Alemania;692;963;8259;23544;6376;39834;11485;51319
2013;12;Francia;274;834;997;4574;928;7607;2876;10483
2013;12;Gran Bretaña;1036;665;9888;44663;13349;69601;51841;121442
2013;12;Irlanda;16;90;624;1448;518;2696;1790;4486
2013;12;Italia;174;267;1249;4094;705;6489;2343;8832
2013;12;Suecia;29;888;3243;10562;1920;16642;18544;35186
2013;12;Noruega;38;653;2609;4273;779;8352;10708;19060
2013;12;Dinamarca;88;605;1635;2902;382;5612;7421;13033
2013;12;Finlandia;45;128;2235;4335;830;7573;11350;18923
2013;12;Suiza;57;123;465;1547;881;3073;916;3989
2013;12;Austria;27;64;332;1175;548;2146;994;3140
2013;12;Rusia;226;99;1191;4102;1849;7467;5551;13018
2013;12;Países del Este;69;286;735;4135;587;5812;2780;8592
2013;12;Resto de Europa;87;179;1400;3140;681;5487;2147;7634
2013;12;Estados Unidos;22;31;146;319;327;845;397;1242
2013;12;Resto de América;121;149;341;229;163;1003;413;1416
2013;12;Resto del Mundo;86;181;486;2617;667;4037;954;4991
2013;12;TOTAL;4970;9612;50883;165039;42448;272952;152443;425395
2013;13;España;17109;45843;175567;524110;106883;869512;292410;1161922
2013;13;Holanda;559;1560;15506;58061;11672;87358;64221;151579
2013;13;Bélgica;519;1122;8920;78775;23600;112936;23177;136113
2013;13;Alemania;3492;7057;93015;276906;71045;451515;106155;557670
2013;13;Francia;2494;10016;15228;65936;12496;106170;43502;149672
2013;13;Gran Bretaña;10288;6968;134247;544108;165614;861225;719682;1580907
2013;13;Irlanda;122;737;9311;21019;6869;38058;34361;72419
2013;13;Italia;1518;2724;17044;39461;6874;67621;26567;94188
2013;13;Suecia;183;2641;17529;54963;10245;85561;97935;183496
2013;13;Noruega;162;5178;14810;26750;6111;53011;69102;122113
2013;13;Dinamarca;249;5001;10873;23166;3032;42321;46418;88739
2013;13;Finlandia;145;390;13722;27452;5012;46721;63948;110669
2013;13;Suiza;433;1064;5807;18048;12273;37625;11053;48678
2013;13;Austria;183;424;3816;16528;5877;26828;7700;34528
2013;13;Rusia;2402;1625;18558;62548;32016;117149;67927;185076
2013;13;Países del Este;490;2868;11253;41986;9770;66367;39011;105378
2013;13;Resto de Europa;782;1446;18409;50946;9863;81446;25486;106932
2013;13;Estados Unidos;183;319;1273;3308;4462;9545;4250;13795
2013;13;Resto de América;1089;1390;3432;2573;1879;10363;4905;15268
2013;13;Resto del Mundo;575;1682;3382;31140;9769;46548;7357;53905
2013;13;TOTAL;42977;100055;591702;1967784;515362;3217880;1755167;4973047
2014;1;España;1694;2548;12313;26289;5134;47978;8246;56224
2014;1;Holanda;84;215;1232;4854;991;7376;4085;11461
2014;1;Bélgica;99;110;993;6819;2043;10064;2378;12442
2014;1;Alemania;664;967;9031;27850;6308;44820;10996;55816
2014;1;Francia;338;998;974;5161;1126;8597;2721;11318
2014;1;Gran Bretaña;1136;790;9595;42278;12641;66440;50487;116927
2014;1;Irlanda;35;94;745;1960;747;3581;2195;5776
2014;1;Italia;249;285;1702;4082;1067;7385;2676;10061
2014;1;Suecia;58;635;3154;9130;1604;14581;15789;30370
2014;1;Noruega;28;760;2365;4110;871;8134;10378;18512
2014;1;Dinamarca;45;472;1669;3126;347;5659;7285;12944
2014;1;Finlandia;31;102;2411;3880;732;7156;10646;17802
2014;1;Suiza;75;110;380;1340;938;2843;762;3605
2014;1;Austria;30;91;454;1559;482;2616;856;3472
2014;1;Rusia;307;150;1725;4883;2635;9700;6697;16397
2014;1;Países del Este;81;290;1136;3210;914;5631;2633;8264
2014;1;Resto de Europa;97;197;1499;3446;849;6088;2368;8456
2014;1;Estados Unidos;18;54;141;225;441;879;271;1150
2014;1;Resto de América;59;120;287;173;137;776;255;1031
2014;1;Resto del Mundo;50;147;310;1573;656;2736;497;3233
2014;1;TOTAL;5178;9135;52116;155948;40663;263040;142221;405261
2014;2;España;1741;3019;13476;27708;6304;52248;7955;60203
2014;2;Holanda;102;229;1343;5141;1156;7971;5113;13084
2014;2;Bélgica;56;133;954;5866;2324;9333;1838;11171
2014;2;Alemania;674;1024;8352;24723;6843;41616;9429;51045
2014;2;Francia;343;1100;1289;6238;1557;10527;3783;14310
2014;2;Gran Bretaña;1023;816;11497;44269;17570;75175;45674;120849
2014;2;Irlanda;21;103;765;1915;1019;3823;1682;5505
2014;2;Italia;244;278;1497;3318;812;6149;1802;7951
2014;2;Suecia;63;723;2488;8800;1482;13556;14110;27666
2014;2;Noruega;55;691;2428;4525;1165;8864;10519;19383
2014;2;Dinamarca;46;499;1703;3480;650;6378;7230;13608
2014;2;Finlandia;46;78;2055;4135;920;7234;10359;17593
2014;2;Suiza;67;134;691;1550;1182;3624;876;4500
2014;2;Austria;53;74;404;1621;727;2879;947;3826
2014;2;Rusia;199;111;826;2560;1276;4972;3662;8634
2014;2;Países del Este;80;254;800;2974;999;5107;2853;7960
2014;2;Resto de Europa;132;149;1390;3458;546;5675;2076;7751
2014;2;Estados Unidos;42;19;148;239;361;809;221;1030
2014;2;Resto de América;66;96;174;205;133;674;288;962
2014;2;Resto del Mundo;69;139;388;1816;1029;3441;585;4026
2014;2;TOTAL;5122;9669;52668;154541;48055;270055;131002;401057
2014;3;España;1748;3419;14030;29257;6086;54540;12118;66658
2014;3;Holanda;101;202;1460;5636;1174;8573;5250;13823
2014;3;Bélgica;74;124;1014;7580;3009;11801;2218;14019
2014;3;Alemania;706;1088;9666;29362;6986;47808;11429;59237
2014;3;Francia;373;1306;1344;7529;1437;11989;4310;16299
2014;3;Gran Bretaña;985;989;13241;48401;17463;81079;53589;134668
2014;3;Irlanda;31;63;756;1812;763;3425;2311;5736
2014;3;Italia;206;263;1687;4769;576;7501;1958;9459
2014;3;Suecia;39;675;2787;9616;1888;15005;15715;30720
2014;3;Noruega;42;807;2683;5148;1064;9744;11937;21681
2014;3;Dinamarca;47;401;2076;3541;612;6677;7776;14453
2014;3;Finlandia;34;47;2365;4342;798;7586;11171;18757
2014;3;Suiza;40;118;555;1673;1153;3539;793;4332
2014;3;Austria;38;57;379;1631;543;2648;638;3286
2014;3;Rusia;252;127;1000;3613;1217;6209;4333;10542
2014;3;Países del Este;100;229;745;3241;329;4644;3129;7773
2014;3;Resto de Europa;100;150;1507;3606;619;5982;2184;8166
2014;3;Estados Unidos;53;45;100;270;334;802;258;1060
2014;3;Resto de América;78;78;203;162;140;661;247;908
2014;3;Resto del Mundo;75;118;443;1504;754;2894;590;3484
2014;3;TOTAL;5122;10306;58041;172693;46945;293107;151954;445061
2014;4;España;2029;3757;15988;40584;9037;71395;28668;100063
2014;4;Holanda;43;118;1161;5185;1029;7536;4777;12313
2014;4;Bélgica;47;113;1163;7176;2629;11128;2176;13304
2014;4;Alemania;392;751;8307;25166;5586;40202;10212;50414
2014;4;Francia;288;1266;1482;8048;1286;12370;4920;17290
2014;4;Gran Bretaña;1077;477;14729;53315;18729;88327;57604;145931
2014;4;Irlanda;32;52;897;2093;717;3791;2964;6755
2014;4;Italia;173;232;1778;3451;641;6275;2430;8705
2014;4;Suecia;15;103;1207;4430;903;6658;7698;14356
2014;4;Noruega;18;258;1519;2632;499;4926;4994;9920
2014;4;Dinamarca;0;190;1308;2347;287;4132;4197;8329
2014;4;Finlandia;15;15;834;2006;296;3166;3603;6769
2014;4;Suiza;72;75;694;1958;1185;3984;1036;5020
2014;4;Austria;25;49;288;1163;432;1957;600;2557
2014;4;Rusia;194;200;1437;3580;1940;7351;4717;12068
2014;4;Países del Este;64;230;644;3549;332;4819;2761;7580
2014;4;Resto de Europa;78;89;1716;4153;698;6734;2146;8880
2014;4;Estados Unidos;51;31;119;327;298;826;442;1268
2014;4;Resto de América;94;68;211;270;141;784;395;1179
2014;4;Resto del Mundo;57;107;549;1378;607;2698;1128;3826
2014;4;TOTAL;4764;8181;56031;172811;47272;289059;147468;436527
2014;5;España;1871;3916;19920;43451;10952;80110;27899;108009
2014;5;Holanda;19;72;801;4218;832;5942;3738;9680
2014;5;Bélgica;45;57;540;5402;1711;7755;1409;9164
2014;5;Alemania;214;450;7152;19923;4844;32583;7796;40379
2014;5;Francia;162;1365;1175;7702;1243;11647;4504;16151
2014;5;Gran Bretaña;891;429;13634;51559;15781;82294;63327;145621
2014;5;Irlanda;5;37;930;2096;553;3621;3378;6999
2014;5;Italia;125;254;1557;3187;494;5617;2534;8151
2014;5;Suecia;8;45;76;218;49;396;468;864
2014;5;Noruega;0;20;217;112;71;420;335;755
2014;5;Dinamarca;1;311;485;577;50;1424;834;2258
2014;5;Finlandia;0;10;134;372;11;527;466;993
2014;5;Suiza;26;35;431;1477;981;2950;683;3633
2014;5;Austria;10;18;306;1215;326;1875;410;2285
2014;5;Rusia;235;182;1886;6140;2196;10639;5352;15991
2014;5;Países del Este;34;166;453;3653;578;4884;3293;8177
2014;5;Resto de Europa;54;117;1429;4606;428;6634;2358;8992
2014;5;Estados Unidos;27;42;89;262;250;670;387;1057
2014;5;Resto de América;84;85;296;245;133;843;404;1247
2014;5;Resto del Mundo;31;87;624;2549;584;3875;1108;4983
2014;5;TOTAL;3842;7698;52135;158964;42067;264706;130683;395389
2014;6;España;1628;4172;18137;51819;11005;86761;34437;121198
2014;6;Holanda;20;23;780;3428;513;4764;2323;7087
2014;6;Bélgica;24;39;670;5698;1257;7688;1160;8848
2014;6;Alemania;141;326;7746;20185;4388;32786;8083;40869
2014;6;Francia;159;769;909;4673;679;7189;3202;10391
2014;6;Gran Bretaña;717;390;15220;48596;12822;77745;61589;139334
2014;6;Irlanda;8;54;1084;2029;560;3735;4335;8070
2014;6;Italia;121;194;1798;2912;356;5381;2362;7743
2014;6;Suecia;10;9;128;486;58;691;764;1455
2014;6;Noruega;10;8;103;423;95;639;673;1312
2014;6;Dinamarca;6;345;203;678;66;1298;872;2170
2014;6;Finlandia;2;9;19;37;32;99;216;315
2014;6;Suiza;19;56;446;1209;782;2512;475;2987
2014;6;Austria;5;28;250;1199;308;1790;321;2111
2014;6;Rusia;210;192;2168;7149;2392;12111;6441;18552
2014;6;Países del Este;51;139;525;4402;462;5579;3287;8866
2014;6;Resto de Europa;47;93;1535;5706;771;8152;2296;10448
2014;6;Estados Unidos;15;28;128;289;428;888;479;1367
2014;6;Resto de América;63;97;273;230;126;789;407;1196
2014;6;Resto del Mundo;73;97;649;2361;556;3736;789;4525
2014;6;TOTAL;3329;7068;52771;163509;37656;264333;134511;398844
2014;7;España;1988;4437;19114;58048;11671;95258;39160;134418
2014;7;Holanda;24;73;1589;4890;664;7240;5362;12602
2014;7;Bélgica;39;54;631;6422;1978;9124;1974;11098
2014;7;Alemania;130;293;8701;20173;3597;32894;9691;42585
2014;7;Francia;204;977;946;5835;1089;9051;4450;13501
2014;7;Gran Bretaña;647;426;17205;51751;14963;84992;68969;153961
2014;7;Irlanda;3;17;840;1724;473;3057;3818;6875
2014;7;Italia;89;189;2271;2425;384;5358;3160;8518
2014;7;Suecia;15;12;350;652;75;1104;761;1865
2014;7;Noruega;25;17;311;981;170;1504;1794;3298
2014;7;Dinamarca;10;462;595;1204;139;2410;1956;4366
2014;7;Finlandia;0;2;13;29;17;61;268;329
2014;7;Suiza;11;35;754;2061;1024;3885;875;4760
2014;7;Austria;11;24;457;1714;383;2589;555;3144
2014;7;Rusia;199;125;2562;7081;2523;12490;6157;18647
2014;7;Países del Este;65;104;829;5477;765;7240;3748;10988
2014;7;Resto de Europa;41;104;1932;6901;1004;9982;2485;12467
2014;7;Estados Unidos;8;22;59;275;329;693;353;1046
2014;7;Resto de América;49;108;271;239;168;835;494;1329
2014;7;Resto del Mundo;53;103;662;2233;665;3716;868;4584
2014;7;TOTAL;3611;7584;60092;180115;42081;293483;156898;450381
2014;8;España;1945;4872;21583;66080;15268;109748;46221;155969
2014;8;Holanda;31;60;1496;5429;599;7615;5013;12628
2014;8;Bélgica;30;61;660;6110;1449;8310;1609;9919
2014;8;Alemania;301;439;10177;24784;4479;40180;13159;53339
2014;8;Francia;284;935;1436;8483;1724;12862;5729;18591
2014;8;Gran Bretaña;951;466;14438;53659;15085;84599;78756;163355
2014;8;Irlanda;6;25;768;1691;374;2864;3887;6751
2014;8;Italia;332;612;3119;5114;799;9976;5349;15325
2014;8;Suecia;8;15;166;513;49;751;607;1358
2014;8;Noruega;6;19;174;340;66;605;557;1162
2014;8;Dinamarca;9;332;517;664;50;1572;607;2179
2014;8;Finlandia;1;1;7;20;11;40;158;198
2014;8;Suiza;26;20;472;1351;631;2500;375;2875
2014;8;Austria;26;34;341;1616;327;2344;497;2841
2014;8;Rusia;237;137;2679;6364;2731;12148;6876;19024
2014;8;Países del Este;36;143;843;4230;697;5949;3161;9110
2014;8;Resto de Europa;50;76;1514;6127;1017;8784;2542;11326
2014;8;Estados Unidos;32;17;92;185;328;654;313;967
2014;8;Resto de América;70;110;302;243;182;907;513;1420
2014;8;Resto del Mundo;85;112;632;2237;702;3768;1108;4876
2014;8;TOTAL;4466;8486;61416;195240;46568;316176;177037;493213
2014;9;España;1696;5982;16506;45045;11946;81175;30702;111877
2014;9;Holanda;6;64;1206;4164;607;6047;3658;9705
2014;9;Bélgica;34;65;827;7024;1646;9596;1353;10949
2014;9;Alemania;212;586;11138;22739;5479;40154;9627;49781
2014;9;Francia;158;860;1011;5829;839;8697;3144;11841
2014;9;Gran Bretaña;1004;447;16401;51754;14980;84586;66006;150592
2014;9;Irlanda;22;29;565;1969;476;3061;2933;5994
2014;9;Italia;265;338;2330;3871;434;7238;3347;10585
2014;9;Suecia;0;71;120;735;87;1013;1032;2045
2014;9;Noruega;3;20;191;487;133;834;822;1656
2014;9;Dinamarca;5;353;329;553;51;1291;915;2206
2014;9;Finlandia;8;10;70;282;56;426;577;1003
2014;9;Suiza;21;65;632;1903;1407;4028;942;4970
2014;9;Austria;20;17;403;1031;350;1821;394;2215
2014;9;Rusia;122;184;3459;4718;1979;10462;6750;17212
2014;9;Países del Este;36;150;949;4691;426;6252;3648;9900
2014;9;Resto de Europa;87;115;2340;5069;837;8448;2215;10663
2014;9;Estados Unidos;13;28;115;292;335;783;235;1018
2014;9;Resto de América;89;69;292;277;205;932;540;1472
2014;9;Resto del Mundo;64;125;805;2863;644;4501;686;5187
2014;9;TOTAL;3865;9578;59689;165296;42917;281345;139526;420871
2014;10;España;1954;5090;17045;39495;8545;72129;22177;94306
2014;10;Holanda;31;104;1526;5753;1100;8514;3983;12497
2014;10;Bélgica;54;89;838;7502;2263;10746;1727;12473
2014;10;Alemania;391;880;8948;23821;7055;41095;12872;53967
2014;10;Francia;278;1131;1611;7764;1482;12266;4606;16872
2014;10;Gran Bretaña;1107;498;18190;60119;19728;99642;69439;169081
2014;10;Irlanda;5;73;875;2026;559;3538;2546;6084
2014;10;Italia;201;338;2182;3965;484;7170;3159;10329
2014;10;Suecia;17;97;1217;3752;846;5929;7755;13684
2014;10;Noruega;13;127;1605;1896;570;4211;5311;9522
2014;10;Dinamarca;8;315;1112;1988;354;3777;3456;7233
2014;10;Finlandia;16;34;1104;2850;403;4407;6068;10475
2014;10;Suiza;38;167;760;2839;2078;5882;1459;7341
2014;10;Austria;19;52;304;1222;335;1932;535;2467
2014;10;Rusia;238;154;2295;4890;1967;9544;7561;17105
2014;10;Países del Este;95;156;855;4626;434;6166;3714;9880
2014;10;Resto de Europa;117;163;2190;4958;699;8127;2890;11017
2014;10;Estados Unidos;6;25;105;258;408;802;236;1038
2014;10;Resto de América;57;109;322;241;168;897;330;1227
2014;10;Resto del Mundo;63;95;701;2165;844;3868;696;4564
2014;10;TOTAL;4708;9697;63785;182130;50322;310642;160520;471162
2014;11;España;1835;3609;14987;31339;5819;57589;12288;69877
2014;11;Holanda;43;144;1354;4840;699;7080;3857;10937
2014;11;Bélgica;107;151;935;7657;2432;11282;1882;13164
2014;11;Alemania;367;1102;9774;32001;8170;51414;11257;62671
2014;11;Francia;390;952;1054;4290;1077;7763;3035;10798
2014;11;Gran Bretaña;1091;992;12046;42954;13763;70846;49852;120698
2014;11;Irlanda;16;103;477;1385;428;2409;1747;4156
2014;11;Italia;158;381;1911;4181;658;7289;3377;10666
2014;11;Suecia;30;372;2740;8321;2119;13582;14776;28358
2014;11;Noruega;26;258;2356;3483;1382;7505;9870;17375
2014;11;Dinamarca;7;2010;1764;2881;660;7322;6468;13790
2014;11;Finlandia;18;61;2213;4258;661;7211;9846;17057
2014;11;Suiza;52;207;558;2383;1463;4663;1008;5671
2014;11;Austria;14;89;487;1755;609;2954;922;3876
2014;11;Rusia;146;149;1078;2883;1195;5451;4148;9599
2014;11;Países del Este;105;204;686;3871;352;5218;2872;8090
2014;11;Resto de Europa;84;223;1582;2952;567;5408;2212;7620
2014;11;Estados Unidos;20;31;132;250;321;754;204;958
2014;11;Resto de América;88;97;310;229;74;798;229;1027
2014;11;Resto del Mundo;79;159;706;708;571;2223;405;2628
2014;11;TOTAL;4676;11294;57150;162621;43020;278761;140255;419016
2014;12;España;1925;3904;14862;33559;8003;62253;13822;76075
2014;12;Holanda;40;201;1433;4538;916;7128;4769;11897
2014;12;Bélgica;70;121;852;7876;2274;11193;2469;13662
2014;12;Alemania;559;1121;8428;25117;5908;41133;10639;51772
2014;12;Francia;369;773;1279;4348;1269;8038;3423;11461
2014;12;Gran Bretaña;1195;771;10886;46501;15207;74560;48634;123194
2014;12;Irlanda;44;63;527;1169;488;2291;1764;4055
2014;12;Italia;216;417;1810;4517;849;7809;3386;11195
2014;12;Suecia;45;315;2657;7236;1673;11926;14963;26889
2014;12;Noruega;43;270;1841;2558;912;5624;7525;13149
2014;12;Dinamarca;39;1573;1885;2523;428;6448;6099;12547
2014;12;Finlandia;55;129;2105;3444;652;6385;10628;17013
2014;12;Suiza;59;119;562;1677;921;3338;826;4164
2014;12;Austria;25;81;393;1498;409;2406;995;3401
2014;12;Rusia;133;123;890;2408;1115;4669;3599;8268
2014;12;Países del Este;54;224;694;3864;464;5300;2914;8214
2014;12;Resto de Europa;112;240;1640;3620;623;6235;2464;8699
2014;12;Estados Unidos;21;71;186;286;437;1001;338;1339
2014;12;Resto de América;72;113;253;237;125;800;307;1107
2014;12;Resto del Mundo;53;164;581;1275;647;2720;850;3570
2014;12;TOTAL;5129;10793;53764;158251;43320;271257;140414;411671
2014;13;España;22054;48725;197961;492674;109770;871184;283693;1154877
2014;13;Holanda;544;1505;15381;58076;10280;85786;51928;137714
2014;13;Bélgica;679;1117;10077;81132;25015;118020;22193;140213
2014;13;Alemania;4751;9027;107420;295844;69643;486685;125190;611875
2014;13;Francia;3346;12432;14510;75900;14808;120996;47827;168823
2014;13;Gran Bretaña;11824;7491;167082;595156;188732;970285;713926;1684211
2014;13;Irlanda;228;713;9229;21869;7157;39196;33560;72756
2014;13;Italia;2379;3781;23642;45792;7554;83148;35540;118688
2014;13;Suecia;308;3072;17090;53889;10833;85192;94438;179630
2014;13;Noruega;269;3255;15793;26695;6998;53010;64715;117725
2014;13;Dinamarca;223;7263;13646;23562;3694;48388;47695;96083
2014;13;Finlandia;226;498;13330;25655;4589;44298;64006;108304
2014;13;Suiza;506;1141;6935;21421;13745;43748;10110;53858
2014;13;Austria;276;614;4466;17224;5231;27811;7670;35481
2014;13;Rusia;2472;1834;22005;56269;23166;105746;66293;172039
2014;13;Países del Este;801;2289;9159;47788;6752;66789;38013;104802
2014;13;Resto de Europa;999;1716;20274;54602;8658;86249;28236;114485
2014;13;Estados Unidos;306;413;1414;3158;4270;9561;3737;13298
2014;13;Resto de América;869;1150;3194;2751;1732;9696;4409;14105
2014;13;Resto del Mundo;752;1453;7050;22662;8259;40176;9310;49486
2014;13;TOTAL;53812;109489;679658;2022119;530886;3395964;1752489;5148453
2015;1;España;1842;3183;13547;25564;5786;49922;9203;59125
2015;1;Holanda;54;138;1369;4586;880;7027;4205;11232
2015;1;Bélgica;80;166;1126;7217;2184;10773;2482;13255
2015;1;Alemania;520;1002;9381;28088;6406;45397;10523;55920
2015;1;Francia;367;970;1417;5628;1277;9659;3514;13173
2015;1;Gran Bretaña;1362;1587;10195;40977;14174;68295;48172;116467
2015;1;Irlanda;19;99;529;1621;703;2971;2035;5006
2015;1;Italia;257;442;2089;5945;1031;9764;4337;14101
2015;1;Suecia;46;477;2895;7104;2024;12546;13194;25740
2015;1;Noruega;37;724;1786;2426;1027;6000;7691;13691
2015;1;Dinamarca;44;1970;2335;3127;603;8079;7526;15605
2015;1;Finlandia;48;325;2149;3277;678;6477;9864;16341
2015;1;Suiza;50;106;503;1302;896;2857;732;3589
2015;1;Austria;19;62;554;1766;556;2957;834;3791
2015;1;Rusia;161;307;1076;2839;1517;5900;4652;10552
2015;1;Países del Este;63;165;1071;3492;591;5382;3091;8473
2015;1;Resto de Europa;105;261;1769;3711;667;6513;3163;9676
2015;1;Estados Unidos;24;27;102;225;297;675;224;899
2015;1;Resto de América;60;79;231;162;132;664;242;906
2015;1;Resto del Mundo;70;158;480;855;482;2045;883;2928
2015;1;TOTAL;5228;12248;54604;149912;41911;263903;136567;400470
2015;2;España;1724;3342;14172;26751;5551;51540;9431;60971
2015;2;Holanda;75;170;1228;4914;993;7380;4914;12294
2015;2;Bélgica;58;228;750;5938;2617;9591;2082;11673
2015;2;Alemania;520;1037;7900;25332;6367;41156;10180;51336
2015;2;Francia;403;1098;1728;6314;1629;11172;5326;16498
2015;2;Gran Bretaña;1227;1791;11600;43144;16409;74171;47463;121634
2015;2;Irlanda;40;166;659;1738;781;3384;1710;5094
2015;2;Italia;178;422;2128;3830;704;7262;2927;10189
2015;2;Suecia;39;526;2429;7112;1742;11848;12624;24472
2015;2;Noruega;20;456;2046;2780;1117;6419;8318;14737
2015;2;Dinamarca;36;1577;2427;3955;795;8790;8311;17101
2015;2;Finlandia;30;356;1971;3539;681;6577;9865;16442
2015;2;Suiza;66;128;540;1382;1130;3246;784;4030
2015;2;Austria;40;78;326;1346;547;2337;769;3106
2015;2;Rusia;103;186;460;1300;400;2449;1730;4179
2015;2;Países del Este;67;161;861;3155;358;4602;2978;7580
2015;2;Resto de Europa;106;221;1445;3330;638;5740;2671;8411
2015;2;Estados Unidos;36;73;157;212;346;824;240;1064
2015;2;Resto de América;65;72;172;245;165;719;191;910
2015;2;Resto del Mundo;40;206;535;1355;477;2613;782;3395
2015;2;TOTAL;4873;12294;53534;147672;43447;261820;133296;395116
2015;3;España;1878;4516;13726;31872;7161;59153;15422;74575
2015;3;Holanda;54;205;1060;4153;782;6254;4204;10458
2015;3;Bélgica;81;155;759;6514;2014;9523;1998;11521
2015;3;Alemania;644;1512;8723;27627;7676;46182;11878;58060
2015;3;Francia;465;958;1764;4924;1364;9475;3532;13007
2015;3;Gran Bretaña;1151;1592;14446;53499;18671;89359;56517;145876
2015;3;Irlanda;10;100;824;1840;774;3548;2100;5648
2015;3;Italia;203;345;2349;4636;738;8271;3260;11531
2015;3;Suecia;36;592;2623;8830;1798;13879;13916;27795
2015;3;Noruega;29;610;2298;3367;1122;7426;8519;15945
2015;3;Dinamarca;17;534;2447;3972;687;7657;7886;15543
2015;3;Finlandia;17;307;2131;4171;636;7262;9367;16629
2015;3;Suiza;50;117;454;1347;1044;3012;703;3715
2015;3;Austria;27;105;368;1290;496;2286;687;2973
2015;3;Rusia;121;187;572;1259;660;2799;2060;4859
2015;3;Países del Este;43;171;915;3309;399;4837;3108;7945
2015;3;Resto de Europa;88;225;2100;3712;656;6781;2933;9714
2015;3;Estados Unidos;25;32;124;279;327;787;264;1051
2015;3;Resto de América;55;99;228;237;152;771;314;1085
2015;3;Resto del Mundo;73;136;397;970;799;2375;1064;3439
2015;3;TOTAL;5067;12498;58308;167808;47956;291637;149732;441369
2015;4;España;1858;5180;16802;41182;7782;72804;27957;100761
2015;4;Holanda;25;110;985;5687;1031;7838;4785;12623
2015;4;Bélgica;49;122;961;9460;2874;13466;1973;15439
2015;4;Alemania;309;691;8820;22372;5471;37663;9276;46939
2015;4;Francia;381;858;1964;8004;1688;12895;4188;17083
2015;4;Gran Bretaña;1172;841;13827;44032;18558;78430;53440;131870
2015;4;Irlanda;16;75;916;1881;708;3596;2578;6174
2015;4;Italia;199;349;3031;4626;892;9097;3407;12504
2015;4;Suecia;22;243;995;3400;1033;5693;5396;11089
2015;4;Noruega;9;81;489;1015;477;2071;2253;4324
2015;4;Dinamarca;15;102;1243;1449;375;3184;3385;6569
2015;4;Finlandia;15;94;713;1334;215;2371;3109;5480
2015;4;Suiza;32;86;604;1988;1486;4196;1206;5402
2015;4;Austria;6;48;340;1037;464;1895;480;2375
2015;4;Rusia;78;179;795;1790;957;3799;2442;6241
2015;4;Países del Este;46;140;1046;3747;427;5406;3728;9134
2015;4;Resto de Europa;74;241;1879;4494;818;7506;2725;10231
2015;4;Estados Unidos;15;50;132;332;422;951;342;1293
2015;4;Resto de América;65;67;310;231;121;794;398;1192
2015;4;Resto del Mundo;37;93;454;1060;668;2312;991;3303
2015;4;TOTAL;4423;9650;56306;159121;46467;275967;134059;410026
2015;5;España;1925;4714;18497;49791;10565;85492;32123;117615
2015;5;Holanda;41;108;1180;5535;1162;8026;4881;12907
2015;5;Bélgica;15;94;717;6172;1865;8863;1661;10524
2015;5;Alemania;212;515;8040;19844;5184;33795;9211;43006
2015;5;Francia;222;1078;1831;7751;1516;12398;4057;16455
2015;5;Gran Bretaña;1177;1036;13730;53403;16798;86144;63059;149203
2015;5;Irlanda;13;89;985;2226;702;4015;3222;7237
2015;5;Italia;136;394;2814;3959;806;8109;3390;11499
2015;5;Suecia;2;38;227;193;66;526;409;935
2015;5;Noruega;2;23;106;68;46;245;299;544
2015;5;Dinamarca;7;61;521;522;77;1188;963;2151
2015;5;Finlandia;8;25;226;351;46;656;552;1208
2015;5;Suiza;24;68;469;1464;1159;3184;619;3803
2015;5;Austria;7;47;256;826;395;1531;418;1949
2015;5;Rusia;82;270;752;2517;1401;5022;3576;8598
2015;5;Países del Este;29;114;849;3602;551;5145;3227;8372
2015;5;Resto de Europa;45;154;1452;4538;532;6721;3202;9923
2015;5;Estados Unidos;16;20;132;206;839;1213;474;1687
2015;5;Resto de América;53;117;441;288;120;1019;543;1562
2015;5;Resto del Mundo;42;112;398;1044;615;2211;1616;3827
2015;5;TOTAL;4058;9077;53623;164300;44445;275503;137502;413005
2015;6;España;1824;5254;16806;52657;11702;88243;38497;126740
2015;6;Holanda;28;63;880;3812;438;5221;3546;8767
2015;6;Bélgica;23;74;688;6534;1361;8680;1678;10358
2015;6;Alemania;147;293;7072;19155;3684;30351;8474;38825
2015;6;Francia;162;708;868;4631;751;7120;3099;10219
2015;6;Gran Bretaña;946;1189;17732;50920;14591;85378;62557;147935
2015;6;Irlanda;8;109;1382;2176;645;4320;5280;9600
2015;6;Italia;123;289;2592;3724;543;7271;3795;11066
2015;6;Suecia;6;48;179;673;58;964;627;1591
2015;6;Noruega;11;82;205;356;69;723;679;1402
2015;6;Dinamarca;1;103;337;793;104;1338;688;2026
2015;6;Finlandia;11;0;34;84;9;138;286;424
2015;6;Suiza;17;44;443;1280;862;2646;483;3129
2015;6;Austria;5;8;235;1096;274;1618;316;1934
2015;6;Rusia;103;256;712;2254;1275;4600;3491;8091
2015;6;Países del Este;27;205;1107;4436;507;6282;3394;9676
2015;6;Resto de Europa;57;217;1853;5471;728;8326;3633;11959
2015;6;Estados Unidos;30;31;159;240;372;832;569;1401
2015;6;Resto de América;57;82;307;263;175;884;519;1403
2015;6;Resto del Mundo;46;98;512;1114;1115;2885;4509;7394
2015;6;TOTAL;3632;9153;54103;161669;39263;267820;146120;413940
2015;7;España;1939;5086;22165;62727;12517;104434;42977;147411
2015;7;Holanda;17;98;1193;5729;800;7837;7058;14895
2015;7;Bélgica;50;113;595;7435;2144;10337;2110;12447
2015;7;Alemania;183;257;7496;20615;3215;31766;9978;41744
2015;7;Francia;223;313;1418;6809;1018;9781;4742;14523
2015;7;Gran Bretaña;1169;1240;18643;56107;17927;95086;64603;159689
2015;7;Irlanda;14;67;955;1830;652;3518;4613;8131
2015;7;Italia;133;277;2663;2925;571;6569;4186;10755
2015;7;Suecia;2;120;173;574;84;953;533;1486
2015;7;Noruega;11;91;97;931;121;1251;949;2200
2015;7;Dinamarca;6;296;333;1073;111;1819;1249;3068
2015;7;Finlandia;1;18;22;67;6;114;102;216
2015;7;Suiza;9;70;470;2246;1163;3958;939;4897
2015;7;Austria;9;24;411;1594;452;2490;772;3262
2015;7;Rusia;93;218;713;2418;1673;5115;3615;8730
2015;7;Países del Este;30;174;1248;5997;672;8121;4646;12767
2015;7;Resto de Europa;60;230;2027;7120;934;10371;4213;14584
2015;7;Estados Unidos;33;44;133;295;401;906;314;1220
2015;7;Resto de América;86;118;389;335;261;1189;637;1826
2015;7;Resto del Mundo;59;112;369;1332;730;2602;1542;4144
2015;7;TOTAL;4127;8966;61513;188159;45452;308217;159778;467995
2015;8;España;1886;7045;23190;69726;15736;117583;48350;165933
2015;8;Holanda;11;80;1462;6331;839;8723;5854;14577
2015;8;Bélgica;27;75;556;8075;1393;10126;1243;11369
2015;8;Alemania;188;492;7747;21020;4151;33598;11505;45103
2015;8;Francia;260;546;2200;8363;2097;13466;5677;19143
2015;8;Gran Bretaña;972;1499;20428;59599;16877;99375;65991;165366
2015;8;Irlanda;4;83;1268;1557;535;3447;3701;7148
2015;8;Italia;245;811;5490;6718;1001;14265;6995;21260
2015;8;Suecia;11;35;117;678;30;871;197;1068
2015;8;Noruega;7;73;77;504;24;685;550;1235
2015;8;Dinamarca;1;381;187;693;48;1310;577;1887
2015;8;Finlandia;2;10;16;36;4;68;52;120
2015;8;Suiza;16;51;334;1412;748;2561;381;2942
2015;8;Austria;14;51;396;1377;382;2220;748;2968
2015;8;Rusia;86;238;749;2186;1489;4748;3176;7924
2015;8;Países del Este;42;229;1015;5044;740;7070;3056;10126
2015;8;Resto de Europa;67;288;2541;6503;1051;10450;3746;14196
2015;8;Estados Unidos;9;24;113;313;379;838;327;1165
2015;8;Resto de América;58;96;408;392;171;1125;469;1594
2015;8;Resto del Mundo;55;130;515;1215;882;2797;1323;4120
2015;8;TOTAL;3961;12237;68809;201742;48577;335326;163918;499244
2015;9;España;1611;5683;15404;50167;11700;84565;29834;114399
2015;9;Holanda;24;133;1156;4541;714;6568;4227;10795
2015;9;Bélgica;29;129;609;6394;1579;8740;1509;10249
2015;9;Alemania;184;813;7735;20896;5168;34796;10100;44896
2015;9;Francia;197;386;1379;5066;832;7860;3437;11297
2015;9;Gran Bretaña;1003;1315;20813;56042;17251;96424;60984;157408
2015;9;Irlanda;14;71;1150;2139;622;3996;3206;7202
2015;9;Italia;231;559;3250;3445;449;7934;3850;11784
2015;9;Suecia;10;119;152;733;55;1069;373;1442
2015;9;Noruega;2;196;109;670;136;1113;910;2023
2015;9;Dinamarca;9;202;105;729;57;1102;1032;2134
2015;9;Finlandia;14;35;33;283;15;380;297;677
2015;9;Suiza;12;93;457;1660;1379;3601;876;4477
2015;9;Austria;13;59;279;1113;351;1815;553;2368
2015;9;Rusia;61;195;858;1968;892;3974;3953;7927
2015;9;Países del Este;76;226;1246;5126;424;7098;3315;10413
2015;9;Resto de Europa;82;299;2319;5043;630;8373;3624;11997
2015;9;Estados Unidos;2;45;137;199;366;749;313;1062
2015;9;Resto de América;68;95;493;298;117;1071;417;1488
2015;9;Resto del Mundo;60;119;417;1295;841;2732;1007;3739
2015;9;TOTAL;3702;10772;58101;167807;43578;283960;133817;417777
2015;10;España;2112;5213;13487;42256;8718;71786;22566;94352
2015;10;Holanda;79;172;1407;6316;1118;9092;5263;14355
2015;10;Bélgica;41;140;593;6400;2071;9245;1898;11143
2015;10;Alemania;294;1052;8588;23067;6821;39822;12725;52547
2015;10;Francia;372;575;1688;7347;1848;11830;5258;17088
2015;10;Gran Bretaña;1148;1707;20242;69715;22788;115600;67280;182880
2015;10;Irlanda;15;159;1095;2380;863;4512;2635;7147
2015;10;Italia;193;427;2650;4534;649;8453;3926;12379
2015;10;Suecia;26;345;1341;3959;793;6464;6340;12804
2015;10;Noruega;13;417;973;1491;497;3391;3736;7127
2015;10;Dinamarca;32;629;917;2380;345;4303;3616;7919
2015;10;Finlandia;15;228;835;2447;319;3844;5663;9507
2015;10;Suiza;48;206;716;2790;1917;5677;1407;7084
2015;10;Austria;17;78;307;1269;456;2127;609;2736
2015;10;Rusia;107;175;1276;2518;1236;5312;4637;9949
2015;10;Países del Este;65;174;1431;5149;439;7258;3982;11240
2015;10;Resto de Europa;130;300;2458;4966;766;8620;4288;12908
2015;10;Estados Unidos;16;64;166;274;376;896;285;1181
2015;10;Resto de América;55;96;536;348;411;1446;449;1895
2015;10;Resto del Mundo;84;166;327;1500;745;2822;892;3714
2015;10;TOTAL;4862;12323;61033;191106;53176;322500;157455;479955
2015;11;España;1873;5406;9892;29048;5251;51470;12694;64164
2015;11;Holanda;108;172;1375;4737;743;7135;3780;10915
2015;11;Bélgica;81;209;964;8475;2627;12356;2118;14474
2015;11;Alemania;500;1284;9471;31989;7825;51069;11708;62777
2015;11;Francia;425;487;1281;3346;936;6475;2707;9182
2015;11;Gran Bretaña;900;1875;16569;52938;16837;89119;52688;141807
2015;11;Irlanda;43;130;760;1828;773;3534;1939;5473
2015;11;Italia;270;413;2515;4798;628;8624;3455;12079
2015;11;Suecia;36;639;1820;8948;1622;13065;11175;24240
2015;11;Noruega;56;751;1218;2761;1155;5941;7256;13197
2015;11;Dinamarca;22;592;1110;3030;427;5181;5720;10901
2015;11;Finlandia;35;223;1409;3521;615;5803;7749;13552
2015;11;Suiza;78;192;552;1974;1432;4228;830;5058
2015;11;Austria;26;105;438;1587;602;2758;773;3531
2015;11;Rusia;80;197;744;1619;824;3464;3243;6707
2015;11;Países del Este;83;206;1221;4233;420;6163;3899;10062
2015;11;Resto de Europa;146;331;2352;3046;762;6637;3307;9944
2015;11;Estados Unidos;33;81;159;244;531;1048;292;1340
2015;11;Resto de América;82;139;519;257;136;1133;250;1383
2015;11;Resto del Mundo;57;131;243;1277;693;2401;606;3007
2015;11;TOTAL;4934;13563;54612;169656;44839;287604;136189;423793
2015;12;España;1926;5163;10166;32594;7745;57594;13583;71177
2015;12;Holanda;89;246;1333;4732;881;7281;5049;12330
2015;12;Bélgica;83;221;778;7794;2403;11279;2330;13609
2015;12;Alemania;525;1183;7931;24035;5098;38772;10690;49462
2015;12;Francia;302;554;1357;4397;1238;7848;3324;11172
2015;12;Gran Bretaña;1082;1544;17759;54025;17999;92409;52672;145081
2015;12;Irlanda;35;129;861;1737;625;3387;2081;5468
2015;12;Italia;240;538;2401;5096;866;9141;4161;13302
2015;12;Suecia;24;653;2253;7809;1285;12024;11299;23323
2015;12;Noruega;18;498;1032;2325;502;4375;5524;9899
2015;12;Dinamarca;16;412;1664;2941;268;5301;5806;11107
2015;12;Finlandia;34;273;1658;3202;478;5645;9649;15294
2015;12;Suiza;68;133;449;1589;993;3232;848;4080
2015;12;Austria;38;92;405;1161;434;2130;685;2815
2015;12;Rusia;96;113;882;1748;844;3683;2722;6405
2015;12;Países del Este;67;266;982;4061;444;5820;3883;9703
2015;12;Resto de Europa;135;359;2302;4121;732;7649;4016;11665
2015;12;Estados Unidos;50;88;188;358;396;1080;418;1498
2015;12;Resto de América;33;110;487;358;169;1157;379;1536
2015;12;Resto del Mundo;68;269;451;1988;797;3573;1118;4691
2015;12;TOTAL;4929;12844;55339;166071;44197;283380;140237;423617
2015;13;España;22398;59785;187854;514335;110214;894586;302637;1197223
2015;13;Holanda;605;1695;14628;61073;10381;88382;57766;146148
2015;13;Bélgica;617;1726;9096;86408;25132;122979;23082;146061
2015;13;Alemania;4226;10131;98904;284040;67066;464367;126248;590615
2015;13;Francia;3779;8531;18895;72580;16194;119979;48861;168840
2015;13;Gran Bretaña;13309;17216;195984;634401;208880;1069790;695426;1765216
2015;13;Irlanda;231;1277;11384;22953;8383;44228;35100;79328
2015;13;Italia;2408;5266;33972;54236;8878;104760;47689;152449
2015;13;Suecia;260;3835;15204;50013;10590;79902;76083;155985
2015;13;Noruega;215;4002;10436;18694;6293;39640;46684;86324
2015;13;Dinamarca;206;6859;13626;24664;3897;49252;46759;96011
2015;13;Finlandia;230;1894;11197;22312;3702;39335;56555;95890
2015;13;Suiza;470;1294;5991;20434;14209;42398;9808;52206
2015;13;Austria;221;757;4315;15462;5409;26164;7644;33808
2015;13;Rusia;1171;2521;9589;24416;13168;50865;39297;90162
2015;13;Países del Este;638;2231;12992;51351;5972;73184;42307;115491
2015;13;Resto de Europa;1095;3126;24497;56055;8914;93687;41521;135208
2015;13;Estados Unidos;289;579;1702;3177;5052;10799;4062;14861
2015;13;Resto de América;737;1170;4521;3414;2130;11972;4808;16780
2015;13;Resto del Mundo;691;1730;5098;15005;8844;31368;16333;47701
2015;13;TOTAL;53796;135625;689885;2035023;543308;3457637;1728670;5186307
2016;1;España;1847;5420;9267;26438;6526;49498;10302;59800
2016;1;Holanda;61;228;1159;4822;753;7023;4059;11082
2016;1;Bélgica;55;257;734;7669;2207;10922;2197;13119
2016;1;Alemania;544;1160;8714;28103;5778;44299;10722;55021
2016;1;Francia;378;549;1715;5473;1157;9272;3295;12567
2016;1;Gran Bretaña;1344;2123;18034;50527;17277;89305;52065;141370
2016;1;Irlanda;35;160;1095;2052;1131;4473;2247;6720
2016;1;Italia;350;594;3266;6685;1536;12431;4633;17064
2016;1;Suecia;46;636;2808;9515;1866;14871;12426;27297
2016;1;Noruega;35;577;1229;2824;770;5435;6922;12357
2016;1;Dinamarca;41;648;2332;4303;425;7749;7525;15274
2016;1;Finlandia;50;232;2041;3335;484;6142;10100;16242
2016;1;Suiza;68;130;475;1288;757;2718;731;3449
2016;1;Austria;38;88;478;1567;388;2559;883;3442
2016;1;Rusia;138;215;951;2141;1321;4766;3274;8040
2016;1;Países del Este;76;230;1082;4757;712;6857;3074;9931
2016;1;Resto de Europa;162;347;2225;4265;520;7519;4287;11806
2016;1;Estados Unidos;25;64;145;246;232;712;304;1016
2016;1;Resto de América;68;117;328;179;129;821;266;1087
2016;1;Resto del Mundo;79;215;435;1083;701;2513;1179;3692
2016;1;TOTAL;5440;13990;58513;167272;44670;289885;140491;430376
2016;2;España;2232;4713;10924;25698;5198;48765;9932;58697
2016;2;Holanda;95;303;1541;5898;1100;8937;5728;14665
2016;2;Bélgica;104;206;697;7755;2474;11236;2016;13252
2016;2;Alemania;675;1072;8866;27902;6317;44832;10202;55034
2016;2;Francia;568;705;2259;6610;1532;11674;4663;16337
2016;2;Gran Bretaña;1389;2123;18017;56576;21036;99141;50730;149871
2016;2;Irlanda;23;124;1153;2249;992;4541;2123;6664
2016;2;Italia;237;483;2907;6114;845;10586;3286;13872
2016;2;Suecia;34;572;1987;7723;1509;11825;9862;21687
2016;2;Noruega;22;625;1244;2917;790;5598;6829;12427
2016;2;Dinamarca;41;699;2076;4515;638;7969;7537;15506
2016;2;Finlandia;49;267;1975;3725;563;6579;9274;15853
2016;2;Suiza;47;126;556;1621;1116;3466;680;4146
2016;2;Austria;40;105;358;1422;514;2439;636;3075
2016;2;Rusia;41;65;625;1228;549;2508;1645;4153
2016;2;Países del Este;76;177;1193;3913;753;6112;3149;9261
2016;2;Resto de Europa;145;332;2382;4266;737;7862;3728;11590
2016;2;Estados Unidos;42;62;177;383;369;1033;296;1329
2016;2;Resto de América;71;74;383;240;129;897;252;1149
2016;2;Resto del Mundo;73;135;427;1824;714;3173;868;4041
2016;2;TOTAL;6004;12968;59747;172579;47875;299173;133436;432609
2016;3;España;2442;5532;13711;35593;8763;66041;21107;87148
2016;3;Holanda;72;286;1376;4456;796;6986;4262;11248
2016;3;Bélgica;89;230;1055;8820;2634;12828;2515;15343
2016;3;Alemania;742;1469;10373;31475;6842;50901;12770;63671
2016;3;Francia;364;613;1825;5422;1479;9703;2928;12631
2016;3;Gran Bretaña;1414;2609;16955;64260;21461;106699;60537;167236
2016;3;Irlanda;10;116;948;2462;1079;4615;2712;7327
2016;3;Italia;245;451;2819;5284;1021;9820;3061;12881
2016;3;Suecia;34;666;1961;7819;1366;11846;10587;22433
2016;3;Noruega;14;483;1222;2714;550;4983;5864;10847
2016;3;Dinamarca;30;661;2148;4476;411;7726;7174;14900
2016;3;Finlandia;32;300;1791;3639;490;6252;9050;15302
2016;3;Suiza;58;156;487;1861;1127;3689;670;4359
2016;3;Austria;36;95;348;1329;495;2303;580;2883
2016;3;Rusia;84;127;729;1481;589;3010;2020;5030
2016;3;Países del Este;119;195;1353;4927;690;7284;3319;10603
2016;3;Resto de Europa;153;350;2379;4408;594;7884;4116;12000
2016;3;Estados Unidos;30;48;173;399;325;975;304;1279
2016;3;Resto de América;71;79;525;251;208;1134;324;1458
2016;3;Resto del Mundo;119;158;410;1580;747;3014;1029;4043
2016;3;TOTAL;6158;14624;62588;192656;51667;327693;154929;482622
2016;4;España;1908;5325;16792;40391;7817;72233;24701;96934
2016;4;Holanda;59;273;2293;8743;1480;12848;7142;19990
2016;4;Bélgica;65;221;869;7512;2095;10762;1947;12709
2016;4;Alemania;281;813;8908;27672;4733;42407;10440;52847
2016;4;Francia;416;854;2582;12582;1943;18377;6169;24546
2016;4;Gran Bretaña;1378;2085;21226;58169;23034;105892;63939;169831
2016;4;Irlanda;22;96;1266;2286;790;4460;2959;7419
2016;4;Italia;194;422;2910;4687;789;9002;3699;12701
2016;4;Suecia;6;285;1060;3030;860;5241;4417;9658
2016;4;Noruega;12;170;335;969;336;1822;2025;3847
2016;4;Dinamarca;8;225;1182;1901;215;3531;3019;6550
2016;4;Finlandia;40;235;701;1314;234;2524;3027;5551
2016;4;Suiza;49;147;629;2133;1485;4443;986;5429
2016;4;Austria;18;88;238;1204;454;2002;436;2438
2016;4;Rusia;74;211;1341;2531;1025;5182;3578;8760
2016;4;Países del Este;86;256;1271;4376;688;6677;4643;11320
2016;4;Resto de Europa;90;358;2962;4335;442;8187;4016;12203
2016;4;Estados Unidos;17;55;189;461;510;1232;333;1565
2016;4;Resto de América;46;145;566;428;132;1317;438;1755
2016;4;Resto del Mundo;53;165;354;1410;782;2764;829;3593
2016;4;TOTAL;4822;12429;67674;186134;49844;320903;148743;469646
2016;5;España;2061;6029;21513;49409;9701;88713;30078;118791
2016;5;Holanda;36;189;1720;5912;763;8620;4611;13231
2016;5;Bélgica;40;104;808;6340;1612;8904;2068;10972
2016;5;Alemania;271;653;8006;27208;4876;41014;10278;51292
2016;5;Francia;297;499;1157;6373;1095;9421;3208;12629
2016;5;Gran Bretaña;1174;2155;22104;63938;19369;108740;65058;173798
2016;5;Irlanda;16;130;1365;2294;781;4586;3398;7984
2016;5;Italia;181;367;1879;5264;724;8415;3689;12104
2016;5;Suecia;9;19;54;202;102;386;329;715
2016;5;Noruega;6;71;64;119;93;353;233;586
2016;5;Dinamarca;3;165;106;667;66;1007;693;1700
2016;5;Finlandia;5;28;66;271;57;427;326;753
2016;5;Suiza;31;155;362;1663;1055;3266;714;3980
2016;5;Austria;11;36;164;862;304;1377;294;1671
2016;5;Rusia;49;203;1549;2872;940;5613;3391;9004
2016;5;Países del Este;83;231;1021;5198;600;7133;3949;11082
2016;5;Resto de Europa;93;329;2325;4292;524;7563;4039;11602
2016;5;Estados Unidos;22;68;121;307;421;939;332;1271
2016;5;Resto de América;40;166;694;342;176;1418;436;1854
2016;5;Resto del Mundo;44;137;468;1430;956;3035;1261;4296
2016;5;TOTAL;4472;11734;65546;184963;44215;310930;138385;449315
2016;6;España;2011;6109;18239;51403;10049;87811;32727;120538
2016;6;Holanda;15;119;1324;5212;572;7242;3641;10883
2016;6;Bélgica;44;134;579;6305;1389;8451;1771;10222
2016;6;Alemania;175;438;8310;26586;3663;39172;9682;48854
2016;6;Francia;154;349;917;5168;722;7310;2710;10020
2016;6;Gran Bretaña;973;2522;21765;62070;18277;105607;70650;176257
2016;6;Irlanda;1;120;1500;2472;728;4821;4840;9661
2016;6;Italia;111;403;2520;3933;607;7574;3524;11098
2016;6;Suecia;11;37;169;468;116;801;541;1342
2016;6;Noruega;2;120;151;489;86;848;618;1466
2016;6;Dinamarca;1;178;135;551;70;935;571;1506
2016;6;Finlandia;3;31;78;78;25;215;139;354
2016;6;Suiza;26;93;371;1460;890;2840;477;3317
2016;6;Austria;2;30;201;1071;323;1627;339;1966
2016;6;Rusia;67;199;1508;2497;1744;6015;3640;9655
2016;6;Países del Este;51;278;1313;6635;782;9059;4216;13275
2016;6;Resto de Europa;79;286;2681;5304;937;9287;4230;13517
2016;6;Estados Unidos;23;68;166;310;569;1136;345;1481
2016;6;Resto de América;56;147;485;378;318;1384;484;1868
2016;6;Resto del Mundo;76;134;402;1508;1300;3420;1348;4768
2016;6;TOTAL;3881;11795;62814;183898;43167;305555;146493;452048
2016;7;España;2521;6265;20705;54268;12163;95922;41076;136998
2016;7;Holanda;36;167;2355;7853;811;11222;6885;18107
2016;7;Bélgica;40;232;1366;9466;2156;13260;2942;16202
2016;7;Alemania;163;527;8714;26352;3135;38891;11291;50182
2016;7;Francia;226;384;2137;6766;1184;10697;4755;15452
2016;7;Gran Bretaña;1371;2438;22642;68814;21848;117113;80548;197661
2016;7;Irlanda;0;209;1454;2318;838;4819;5420;10239
2016;7;Italia;155;311;2707;3995;556;7724;4035;11759
2016;7;Suecia;3;61;134;446;155;799;502;1301
2016;7;Noruega;9;232;129;756;104;1230;945;2175
2016;7;Dinamarca;3;293;252;767;99;1414;1352;2766
2016;7;Finlandia;4;10;24;69;36;143;109;252
2016;7;Suiza;28;127;580;2866;1161;4762;937;5699
2016;7;Austria;8;44;354;1964;435;2805;707;3512
2016;7;Rusia;63;185;1122;2648;1313;5331;4113;9444
2016;7;Países del Este;33;323;1170;6938;1034;9498;3305;12803
2016;7;Resto de Europa;105;418;2714;6325;685;10247;4347;14594
2016;7;Estados Unidos;22;67;183;302;611;1185;500;1685
2016;7;Resto de América;73;168;441;386;333;1401;649;2050
2016;7;Resto del Mundo;49;157;439;2325;1261;4231;1421;5652
2016;7;TOTAL;4912;12618;69622;205624;49918;342694;175839;518533
2016;8;España;1802;6621;19242;63662;14088;105415;38719;144134
2016;8;Holanda;27;133;2296;8985;959;12400;6319;18719
2016;8;Bélgica;42;324;873;7548;1483;10270;1854;12124
2016;8;Alemania;179;622;9202;25841;4081;39925;11433;51358
2016;8;Francia;269;580;2126;6932;1730;11637;5245;16882
2016;8;Gran Bretaña;1184;2821;20429;67925;19547;111906;78888;190794
2016;8;Irlanda;11;134;1300;1885;652;3982;4459;8441
2016;8;Italia;212;882;4338;6340;824;12596;6190;18786
2016;8;Suecia;18;35;82;724;77;936;244;1180
2016;8;Noruega;5;129;63;415;37;649;516;1165
2016;8;Dinamarca;7;77;98;692;69;943;403;1346
2016;8;Finlandia;0;10;8;32;58;108;42;150
2016;8;Suiza;15;40;308;1405;678;2446;382;2828
2016;8;Austria;9;55;277;1268;369;1978;507;2485
2016;8;Rusia;64;106;1001;2534;1308;5013;3098;8111
2016;8;Países del Este;56;222;1317;6678;1037;9310;2831;12141
2016;8;Resto de Europa;104;369;3071;6420;1174;11138;4470;15608
2016;8;Estados Unidos;10;36;137;282;430;895;377;1272
2016;8;Resto de América;74;126;384;300;234;1118;527;1645
2016;8;Resto del Mundo;61;211;533;2365;1254;4424;1442;5866
2016;8;TOTAL;4149;13533;67085;212233;50089;347089;167946;515035
2016;9;España;2186;6426;15316;49146;12001;85075;28419;113494
2016;9;Holanda;46;157;1747;5440;1002;8392;3992;12384
2016;9;Bélgica;18;171;791;6654;1497;9131;1852;10983
2016;9;Alemania;262;863;8828;27466;5262;42681;10224;52905
2016;9;Francia;174;404;1691;4534;723;7526;3486;11012
2016;9;Gran Bretaña;1374;3185;23551;64029;19102;111241;75223;186464
2016;9;Irlanda;19;117;1146;2281;824;4387;4159;8546
2016;9;Italia;248;425;2691;3883;527;7774;3848;11622
2016;9;Suecia;5;70;145;536;105;861;377;1238
2016;9;Noruega;4;161;96;312;96;669;485;1154
2016;9;Dinamarca;10;48;121;549;93;821;421;1242
2016;9;Finlandia;2;23;28;180;58;291;338;629
2016;9;Suiza;21;142;498;1753;1224;3638;1516;5154
2016;9;Austria;16;62;327;1162;428;1995;408;2403
2016;9;Rusia;86;137;1796;2473;1054;5546;3861;9407
2016;9;Países del Este;62;202;1735;6033;580;8612;3292;11904
2016;9;Resto de Europa;73;377;2861;4785;903;8999;4611;13610
2016;9;Estados Unidos;20;34;127;360;1084;1625;287;1912
2016;9;Resto de América;59;125;486;313;341;1324;466;1790
2016;9;Resto del Mundo;55;180;476;1659;1367;3737;1053;4790
2016;9;TOTAL;4740;13309;64457;183548;48271;314325;148318;462643
2016;10;España;2064;6144;15167;40024;8438;71837;18453;90290
2016;10;Holanda;30;219;1837;6586;1104;9776;4776;14552
2016;10;Bélgica;59;257;980;8076;2583;11955;1916;13871
2016;10;Alemania;316;1254;10562;29493;6875;48500;13405;61905
2016;10;Francia;317;599;2048;6563;1473;11000;4400;15400
2016;10;Gran Bretaña;1176;2533;19081;70339;23561;116690;70835;187525
2016;10;Irlanda;18;173;1052;2451;1052;4746;3143;7889
2016;10;Italia;233;411;2729;4817;689;8879;3552;12431
2016;10;Suecia;14;454;1227;4050;944;6689;6680;13369
2016;10;Noruega;12;604;1287;2315;582;4800;5022;9822
2016;10;Dinamarca;5;449;835;2116;339;3744;3620;7364
2016;10;Finlandia;6;195;675;1967;442;3285;6264;9549
2016;10;Suiza;37;307;863;3276;2369;6852;1681;8533
2016;10;Austria;43;64;336;1505;493;2441;573;3014
2016;10;Rusia;99;204;1372;2393;1043;5111;3889;9000
2016;10;Países del Este;68;176;1573;5622;882;8321;4294;12615
2016;10;Resto de Europa;82;490;2850;4471;1170;9063;4336;13399
2016;10;Estados Unidos;34;35;140;319;619;1147;272;1419
2016;10;Resto de América;63;156;491;392;189;1291;272;1563
2016;10;Resto del Mundo;55;172;493;1829;1720;4269;1131;5400
2016;10;TOTAL;4731;14896;65598;198604;56567;340396;158514;498910
2016;11;España;2089;5544;13667;30902;5358;57560;10793;68353
2016;11;Holanda;47;238;1534;4849;847;7515;3561;11076
2016;11;Bélgica;55;233;985;7619;2335;11227;1961;13188
2016;11;Alemania;473;1507;9593;31092;7484;50149;11457;61606
2016;11;Francia;293;515;1498;3501;983;6790;2373;9163
2016;11;Gran Bretaña;1172;2037;17525;53620;16131;90485;55655;146140
2016;11;Irlanda;18;141;963;1877;844;3843;2123;5966
2016;11;Italia;221;440;2382;4520;877;8440;3025;11465
2016;11;Suecia;39;831;2487;8873;1698;13928;10423;24351
2016;11;Noruega;20;512;1723;3129;908;6292;6751;13043
2016;11;Dinamarca;21;504;933;2882;350;4690;5360;10050
2016;11;Finlandia;23;222;1711;3880;595;6431;9189;15620
2016;11;Suiza;42;267;575;2112;1548;4544;869;5413
2016;11;Austria;14;97;475;1573;710;2869;818;3687
2016;11;Rusia;97;183;1184;1856;798;4118;2920;7038
2016;11;Países del Este;76;218;1145;4846;641;6926;3342;10268
2016;11;Resto de Europa;119;397;2409;3656;902;7483;3546;11029
2016;11;Estados Unidos;12;45;130;414;458;1059;215;1274
2016;11;Resto de América;90;119;414;353;216;1192;215;1407
2016;11;Resto del Mundo;49;149;348;1465;1473;3484;823;4307
2016;11;TOTAL;4970;14199;61681;173019;45156;299025;135419;434444
2016;12;España;2061;5500;11533;32720;9114;60928;13121;74049
2016;12;Holanda;107;300;1349;4524;870;7150;3806;10956
2016;12;Bélgica;60;206;903;7439;1938;10546;2497;13043
2016;12;Alemania;524;1206;8961;23944;5999;40634;10980;51614
2016;12;Francia;312;512;2409;5127;1785;10145;3348;13493
2016;12;Gran Bretaña;1530;2434;18962;58123;18076;99125;63021;162146
2016;12;Irlanda;24;172;921;1950;761;3828;2817;6645
2016;12;Italia;226;567;2657;5221;1147;9818;3794;13612
2016;12;Suecia;43;595;2715;7568;1330;12251;9901;22152
2016;12;Noruega;34;577;1453;2098;563;4725;5521;10246
2016;12;Dinamarca;21;532;1307;2722;368;4950;5596;10546
2016;12;Finlandia;33;257;1650;3510;629;6079;9510;15589
2016;12;Suiza;36;206;464;1577;910;3193;728;3921
2016;12;Austria;39;88;490;1477;469;2563;760;3323
2016;12;Rusia;90;130;1258;2008;827;4313;2854;7167
2016;12;Países del Este;63;243;1306;5217;485;7314;3479;10793
2016;12;Resto de Europa;85;418;2492;4015;935;7945;3910;11855
2016;12;Estados Unidos;38;115;282;505;648;1588;403;1991
2016;12;Resto de América;73;122;438;282;188;1103;344;1447
2016;12;Resto del Mundo;84;251;643;1996;1441;4415;1580;5995
2016;12;TOTAL;5483;14431;62193;172023;48483;302613;147970;450583
2016;13;España;25224;69628;186076;499654;109216;889798;279428;1169226
2016;13;Holanda;631;2612;20531;73280;11057;108111;58782;166893
2016;13;Bélgica;671;2575;10640;91203;24403;129492;25536;155028
2016;13;Alemania;4605;11584;109037;333134;65045;523405;132884;656289
2016;13;Francia;3768;6563;22364;75051;15806;123552;46580;170132
2016;13;Gran Bretaña;15479;29065;240291;738390;238719;1261944;787149;2049093
2016;13;Irlanda;197;1692;14163;26577;10472;53101;40400;93501
2016;13;Italia;2613;5756;33805;60743;10142;113059;46336;159395
2016;13;Suecia;262;4261;14829;50954;10128;80434;66289;146723
2016;13;Noruega;175;4261;8996;19057;4915;37404;41731;79135
2016;13;Dinamarca;191;4479;11525;26141;3143;45479;43271;88750
2016;13;Finlandia;247;1810;10748;22000;3671;38476;57368;95844
2016;13;Suiza;458;1896;6168;23015;14320;45857;10371;56228
2016;13;Austria;274;852;4046;16404;5382;26958;6941;33899
2016;13;Rusia;952;1965;14436;26662;12511;56526;38283;94809
2016;13;Países del Este;849;2751;15479;65140;8884;93103;42893;135996
2016;13;Resto de Europa;1290;4471;31351;56542;9523;103177;49636;152813
2016;13;Estados Unidos;295;697;1970;4288;6276;13526;3968;17494
2016;13;Resto de América;784;1544;5635;3844;2593;14400;4673;19073
2016;13;Resto del Mundo;797;2064;5428;20474;13716;42479;13964;56443
2016;13;TOTAL;59762;160526;767518;2232553;579922;3800281;1796483;5596764
2017;1;España;1792;5008;10654;26974;5790;50218;8807;59025
2017;1;Holanda;121;276;1414;5148;1024;7983;3865;11848
2017;1;Bélgica;66;214;906;7753;2792;11731;2081;13812
2017;1;Alemania;523;1271;7965;26094;5954;41807;9900;51707
2017;1;Francia;350;609;2221;5480;1306;9966;3046;13012
2017;1;Gran Bretaña;1367;2525;15064;51427;18178;88561;53360;141921
2017;1;Irlanda;39;125;930;2263;1093;4450;2593;7043
2017;1;Italia;285;584;2511;7093;1266;11739;3945;15684
2017;1;Suecia;54;796;3264;9773;2168;16055;11491;27546
2017;1;Noruega;43;505;1093;2941;793;5375;6658;12033
2017;1;Dinamarca;41;619;1878;4674;605;7817;6902;14719
2017;1;Finlandia;46;262;1807;3620;660;6395;9568;15963
2017;1;Suiza;34;169;432;1409;1032;3076;720;3796
2017;1;Austria;24;89;452;1522;522;2609;700;3309
2017;1;Rusia;89;185;1034;2283;1316;4907;2833;7740
2017;1;Países del Este;79;322;1211;5334;617;7563;3192;10755
2017;1;Resto de Europa;194;503;1795;3541;1018;7051;3538;10589
2017;1;Estados Unidos;40;72;163;312;377;964;231;1195
2017;1;Resto de América;51;117;291;396;234;1089;268;1357
2017;1;Resto del Mundo;73;212;443;1515;1066;3309;982;4291
2017;1;TOTAL;5311;14463;55528;169552;47811;292665;134680;427345
2017;2;España;1739;5405;10924;26928;5433;50429;9236;59665
2017;2;Holanda;111;390;1489;6012;1168;9170;4596;13766
2017;2;Bélgica;41;349;812;7282;2668;11152;2075;13227
2017;2;Alemania;462;2198;7438;24263;6283;40644;9646;50290
2017;2;Francia;339;969;2813;7578;1575;13274;4613;17887
2017;2;Gran Bretaña;1386;1798;15033;53855;21573;93645;52441;146086
2017;2;Irlanda;13;409;764;2042;1140;4368;2092;6460
2017;2;Italia;220;794;2039;5299;945;9297;2842;12139
2017;2;Suecia;31;894;2132;8194;1793;13044;8915;21959
2017;2;Noruega;34;554;1186;2766;770;5310;6269;11579
2017;2;Dinamarca;16;1784;1804;4693;928;9225;6984;16209
2017;2;Finlandia;28;138;1578;3726;821;6291;8347;14638
2017;2;Suiza;37;285;422;1729;1211;3684;553;4237
2017;2;Austria;37;208;416;1677;648;2986;779;3765
2017;2;Rusia;38;176;430;1332;551;2527;1744;4271
2017;2;Países del Este;70;319;1080;5298;596;7363;3181;10544
2017;2;Resto de Europa;111;684;2009;4398;1103;8305;4058;12363
2017;2;Estados Unidos;22;104;163;445;506;1240;276;1516
2017;2;Resto de América;51;213;249;346;212;1071;240;1311
2017;2;Resto del Mundo;81;366;441;1985;1246;4119;1027;5146
2017;2;TOTAL;4867;18037;53222;169848;51170;297144;129914;427058
2017;3;España;1871;6214;13677;31302;6786;59850;12266;72116
2017;3;Holanda;87;434;1380;4922;1025;7848;3867;11715
2017;3;Bélgica;59;400;885;6947;2560;10851;2465;13316
2017;3;Alemania;519;2556;9006;29179;6947;48207;11439;59646
2017;3;Francia;393;1154;2345;6254;1486;11632;3670;15302
2017;3;Gran Bretaña;1563;1617;17563;62260;24025;107028;67016;174044
2017;3;Irlanda;25;325;987;2344;899;4580;2634;7214
2017;3;Italia;222;654;2187;4848;985;8896;3198;12094
2017;3;Suecia;35;871;2723;7556;1346;12531;8867;21398
2017;3;Noruega;9;364;945;2564;638;4520;6126;10646
2017;3;Dinamarca;21;1561;1596;3922;531;7631;5847;13478
2017;3;Finlandia;30;181;1608;3569;602;5990;8141;14131
2017;3;Suiza;20;379;408;1770;1146;3723;515;4238
2017;3;Austria;14;227;371;1241;480;2333;513;2846
2017;3;Rusia;53;161;586;1676;792;3268;2491;5759
2017;3;Países del Este;80;243;1266;5500;555;7644;3942;11586
2017;3;Resto de Europa;161;659;2637;4123;978;8558;4364;12922
2017;3;Estados Unidos;46;120;217;648;607;1638;423;2061
2017;3;Resto de América;71;184;271;365;245;1136;342;1478
2017;3;Resto del Mundo;46;250;473;2268;1331;4368;1136;5504
2017;3;TOTAL;5325;18554;61131;183258;53964;322232;149262;471494
2017;4;España;2176;7923;18419;48034;10178;86730;29370;116100
2017;4;Holanda;43;340;1747;7602;1477;11209;6488;17697
2017;4;Bélgica;44;300;1023;8275;2373;12015;2054;14069
2017;4;Alemania;332;2204;8136;25275;5589;41536;10843;52379
2017;4;Francia;294;1162;3213;11086;1620;17375;5609;22984
2017;4;Gran Bretaña;1157;1192;17742;65141;22827;108059;70284;178343
2017;4;Irlanda;7;230;955;2558;1086;4836;3404;8240
2017;4;Italia;158;700;2287;5192;1226;9563;3301;12864
2017;4;Suecia;17;553;1611;4413;838;7432;5374;12806
2017;4;Noruega;8;169;446;1394;541;2558;2777;5335
2017;4;Dinamarca;24;785;1170;2414;319;4712;3450;8162
2017;4;Finlandia;11;70;624;2085;269;3059;3700;6759
2017;4;Suiza;79;385;582;2346;1565;4957;1017;5974
2017;4;Austria;13;136;292;1317;606;2364;584;2948
2017;4;Rusia;64;191;863;1994;1272;4384;2657;7041
2017;4;Países del Este;56;244;1227;6035;761;8323;3777;12100
2017;4;Resto de Europa;139;614;2588;4476;1126;8943;4895;13838
2017;4;Estados Unidos;48;73;247;514;960;1842;350;2192
2017;4;Resto de América;61;161;302;440;257;1221;345;1566
2017;4;Resto del Mundo;54;259;563;2213;1117;4206;1585;5791
2017;4;TOTAL;4785;17691;64037;202804;56007;345324;161864;507188
2017;5;España;1787;7375;17785;48395;10110;85452;28980;114432
2017;5;Holanda;17;204;1340;5885;927;8373;4861;13234
2017;5;Bélgica;43;328;801;6204;2063;9439;2009;11448
2017;5;Alemania;155;1258;6504;23747;4379;36043;8399;44442
2017;5;Francia;224;957;1801;6730;1174;10886;3641;14527
2017;5;Gran Bretaña;1004;1042;17322;67397;20123;106888;77805;184693
2017;5;Irlanda;7;270;1177;2651;799;4904;4085;8989
2017;5;Italia;143;586;2423;4911;664;8727;3370;12097
2017;5;Suecia;8;46;168;314;111;647;449;1096
2017;5;Noruega;4;104;67;152;98;425;397;822
2017;5;Dinamarca;2;44;198;707;143;1094;980;2074
2017;5;Finlandia;5;24;209;245;151;634;466;1100
2017;5;Suiza;23;203;321;1749;1259;3555;752;4307
2017;5;Austria;5;134;177;1127;366;1809;490;2299
2017;5;Rusia;49;165;1411;2431;998;5054;2944;7998
2017;5;Países del Este;98;308;1586;6289;584;8865;3620;12485
2017;5;Resto de Europa;115;470;2618;4023;573;7799;4634;12433
2017;5;Estados Unidos;8;75;165;480;696;1424;440;1864
2017;5;Resto de América;74;178;329;344;248;1173;661;1834
2017;5;Resto del Mundo;65;252;477;1694;991;3479;995;4474
2017;5;TOTAL;3836;14023;56879;185475;46457;306670;149978;456648
2017;6;España;1858;6847;20252;56369;13530;98856;35939;134795
2017;6;Holanda;24;255;1156;4635;785;6855;4001;10856
2017;6;Bélgica;18;214;897;6299;1554;8982;1898;10880
2017;6;Alemania;174;723;7443;27216;4234;39790;10576;50366
2017;6;Francia;145;436;1292;5330;780;7983;2928;10911
2017;6;Gran Bretaña;1296;2321;18581;66604;18504;107306;84286;191592
2017;6;Irlanda;12;491;1370;2967;999;5839;5865;11704
2017;6;Italia;101;372;2157;4107;741;7478;3266;10744
2017;6;Suecia;8;34;194;645;105;986;570;1556
2017;6;Noruega;13;99;72;332;107;623;648;1271
2017;6;Dinamarca;2;26;197;817;72;1114;660;1774
2017;6;Finlandia;0;27;38;83;78;226;268;494
2017;6;Suiza;19;126;312;1398;1008;2863;424;3287
2017;6;Austria;12;51;241;1026;428;1758;287;2045
2017;6;Rusia;97;160;1263;2449;1256;5225;3637;8862
2017;6;Países del Este;58;418;1724;7349;791;10340;4075;14415
2017;6;Resto de Europa;53;485;2669;5640;651;9498;4674;14172
2017;6;Estados Unidos;35;110;184;475;595;1399;469;1868
2017;6;Resto de América;46;114;309;401;205;1075;489;1564
2017;6;Resto del Mundo;50;211;382;1670;1241;3554;1216;4770
2017;6;TOTAL;4021;13520;60733;195812;47664;321750;166176;487926
2017;7;España;2508;7130;18142;65781;15127;108688;36798;145486
2017;7;Holanda;24;243;1812;7863;982;10924;6760;17684
2017;7;Bélgica;20;315;937;9368;2143;12783;2438;15221
2017;7;Alemania;196;529;7659;22337;3340;34061;10984;45045
2017;7;Francia;184;441;2201;7746;1270;11842;4972;16814
2017;7;Gran Bretaña;1002;2002;19306;66399;18986;107695;80233;187928
2017;7;Irlanda;0;392;1475;2438;952;5257;6365;11622
2017;7;Italia;150;392;2557;4212;561;7872;3578;11450
2017;7;Suecia;15;50;257;600;196;1118;649;1767
2017;7;Noruega;6;77;247;766;244;1340;1145;2485
2017;7;Dinamarca;0;64;323;885;177;1449;1165;2614
2017;7;Finlandia;10;13;12;37;76;148;124;272
2017;7;Suiza;25;135;568;2382;1348;4458;895;5353
2017;7;Austria;6;99;339;1798;436;2678;662;3340
2017;7;Rusia;47;134;1099;2366;1480;5126;3170;8296
2017;7;Países del Este;23;300;1932;7887;914;11056;4163;15219
2017;7;Resto de Europa;80;564;2619;8107;950;12320;5218;17538
2017;7;Estados Unidos;23;75;160;520;763;1541;410;1951
2017;7;Resto de América;89;148;383;419;277;1316;427;1743
2017;7;Resto del Mundo;117;183;658;2496;1480;4934;1599;6533
2017;7;TOTAL;4525;13286;62686;214407;51702;346606;171755;518361
2017;8;España;2028;7147;18351;65390;15799;108715;39897;148612
2017;8;Holanda;24;310;2220;8460;1032;12046;6976;19022
2017;8;Bélgica;13;187;520;7810;1946;10476;1484;11960
2017;8;Alemania;197;825;8052;22120;3794;34988;11031;46019
2017;8;Francia;283;713;2256;8184;1699;13135;4831;17966
2017;8;Gran Bretaña;1095;2081;19121;65569;19606;107472;84454;191926
2017;8;Irlanda;2;365;1387;2595;845;5194;5763;10957
2017;8;Italia;194;804;3235;6192;852;11277;5246;16523
2017;8;Suecia;3;27;228;665;75;998;487;1485
2017;8;Noruega;0;69;167;519;112;867;507;1374
2017;8;Dinamarca;3;18;301;646;67;1035;585;1620
2017;8;Finlandia;9;11;19;26;143;208;102;310
2017;8;Suiza;13;69;263;1368;701;2414;386;2800
2017;8;Austria;31;56;234;1267;469;2057;520;2577
2017;8;Rusia;50;213;976;2270;1504;5013;2994;8007
2017;8;Países del Este;33;449;1425;7094;1080;10081;4023;14104
2017;8;Resto de Europa;101;405;2837;7335;1259;11937;4004;15941
2017;8;Estados Unidos;10;50;101;325;563;1049;370;1419
2017;8;Resto de América;50;140;386;383;235;1194;450;1644
2017;8;Resto del Mundo;77;230;538;2712;1691;5248;1420;6668
2017;8;TOTAL;4216;14169;62617;210930;53472;345404;175530;520934
2017;9;España;2618;7744;15209;49816;13484;88871;28404;117275
2017;9;Holanda;49;318;1408;5640;1414;8829;4615;13444
2017;9;Bélgica;30;193;683;6938;2368;10212;1885;12097
2017;9;Alemania;261;1136;7719;26470;6213;41799;10689;52488
2017;9;Francia;169;512;1877;5935;1406;9899;3861;13760
2017;9;Gran Bretaña;1358;2364;18550;63678;21521;107471;83257;190728
2017;9;Irlanda;13;311;1325;2889;987;5525;4772;10297
2017;9;Italia;172;575;2320;4219;528;7814;3865;11679
2017;9;Suecia;3;46;269;549;157;1024;603;1627
2017;9;Noruega;5;43;187;452;106;793;629;1422
2017;9;Dinamarca;1;105;159;588;142;995;607;1602
2017;9;Finlandia;2;31;65;241;79;418;418;836
2017;9;Suiza;38;152;448;2192;1524;4354;849;5203
2017;9;Austria;24;70;293;1510;397;2294;534;2828
2017;9;Rusia;54;210;1108;2333;1102;4807;3493;8300
2017;9;Países del Este;50;368;1705;6153;767;9043;4222;13265
2017;9;Resto de Europa;76;500;2573;6090;5623;14862;4117;18979
2017;9;Estados Unidos;29;91;72;347;514;1053;249;1302
2017;9;Resto de América;116;155;389;380;360;1400;464;1864
2017;9;Resto del Mundo;132;196;417;2214;1144;4103;1168;5271
2017;9;TOTAL;5200;15120;56776;188634;59836;325566;158701;484267
2017;10;España;2244;5907;14756;43988;8983;75878;19865;95743
2017;10;Holanda;26;464;1873;6973;1478;10814;5880;16694
2017;10;Bélgica;29;205;794;7261;3256;11545;1709;13254
2017;10;Alemania;340;1492;8988;27808;7834;46462;13040;59502
2017;10;Francia;227;697;2411;7827;1560;12722;5143;17865
2017;10;Gran Bretaña;1040;2064;17685;63203;22983;106975;70233;177208
2017;10;Irlanda;24;350;1187;2710;756;5027;4010;9037
2017;10;Italia;179;433;2325;4752;595;8284;3281;11565
2017;10;Suecia;38;312;1347;4398;907;7002;7452;14454
2017;10;Noruega;19;308;746;1789;508;3370;4524;7894
2017;10;Dinamarca;21;376;813;2176;779;4165;3331;7496
2017;10;Finlandia;9;108;721;2892;492;4222;6448;10670
2017;10;Suiza;22;285;751;3080;2527;6665;1409;8074
2017;10;Austria;5;91;241;1439;598;2374;599;2973
2017;10;Rusia;97;272;1286;2448;1228;5331;3506;8837
2017;10;Países del Este;54;372;1925;6691;751;9793;4419;14212
2017;10;Resto de Europa;92;602;2394;5404;1038;9530;4479;14009
2017;10;Estados Unidos;15;63;128;531;884;1621;316;1937
2017;10;Resto de América;103;164;426;639;345;1677;385;2062
2017;10;Resto del Mundo;175;281;612;2714;1536;5318;1213;6531
2017;10;TOTAL;4759;14846;61409;198723;59038;338775;161242;500017
2017;11;España;2223;5170;12454;32684;6598;59129;12337;71466
2017;11;Holanda;37;260;1370;4579;940;7186;3925;11111
2017;11;Bélgica;61;223;885;6873;2742;10784;1981;12765
2017;11;Alemania;503;1811;9206;32578;9403;53501;12478;65979
2017;11;Francia;296;695;1838;4711;1042;8582;2782;11364
2017;11;Gran Bretaña;962;2465;14114;53604;16921;88066;60003;148069
2017;11;Irlanda;22;299;774;2216;847;4158;2455;6613
2017;11;Italia;199;466;1843;4927;697;8132;2986;11118
2017;11;Suecia;38;577;2215;8620;1888;13338;10033;23371
2017;11;Noruega;23;265;913;2500;742;4443;5863;10306
2017;11;Dinamarca;25;616;852;2708;544;4745;4822;9567
2017;11;Finlandia;31;218;1492;4603;1198;7542;9723;17265
2017;11;Suiza;59;297;379;2068;1592;4395;1129;5524
2017;11;Austria;18;133;416;1687;872;3126;819;3945
2017;11;Rusia;90;214;913;1957;971;4145;2612;6757
2017;11;Países del Este;77;476;1747;5675;839;8814;3552;12366
2017;11;Resto de Europa;105;499;2105;3838;969;7516;3438;10954
2017;11;Estados Unidos;45;80;252;510;784;1671;241;1912
2017;11;Resto de América;64;136;263;520;197;1180;197;1377
2017;11;Resto del Mundo;86;163;553;2010;1518;4330;571;4901
2017;11;TOTAL;4964;15063;54584;178868;51304;304783;141947;446730
2017;12;España;2101;5679;11778;35477;9900;64935;14153;79088
2017;12;Holanda;35;363;1172;5140;1057;7767;4690;12457
2017;12;Bélgica;38;312;779;7774;2420;11323;2788;14111
2017;12;Alemania;439;1223;7231;24948;5896;39737;11983;51720
2017;12;Francia;272;531;1664;6206;1144;9817;3339;13156
2017;12;Gran Bretaña;1294;2172;15476;52189;17496;88627;63578;152205
2017;12;Irlanda;15;244;828;2159;871;4117;3138;7255
2017;12;Italia;213;528;2140;5410;1037;9328;4126;13454
2017;12;Suecia;47;615;3434;8393;1856;14345;12234;26579
2017;12;Noruega;22;290;831;2041;775;3959;5399;9358
2017;12;Dinamarca;9;514;1277;2948;526;5274;5038;10312
2017;12;Finlandia;41;304;1579;4308;1136;7368;10455;17823
2017;12;Suiza;42;215;361;1615;1122;3355;706;4061
2017;12;Austria;19;74;343;1497;499;2432;632;3064
2017;12;Rusia;75;140;889;1721;925;3750;2528;6278
2017;12;Países del Este;47;349;1476;5946;956;8774;3864;12638
2017;12;Resto de Europa;79;582;1890;4242;1009;7802;4187;11989
2017;12;Estados Unidos;41;93;252;554;577;1517;371;1888
2017;12;Resto de América;59;116;335;510;366;1386;393;1779
2017;12;Resto del Mundo;115;249;696;2692;1695;5447;1417;6864
2017;12;TOTAL;5003;14593;54431;175770;51263;301060;155019;456079
2017;13;España;24945;77549;182401;531138;121718;937751;276052;1213803
2017;13;Holanda;598;3857;18381;72859;13309;109004;60524;169528
2017;13;Bélgica;462;3240;9922;88784;28885;131293;24867;156160
2017;13;Alemania;4101;17226;95347;312035;69866;498575;131008;629583
2017;13;Francia;3176;8876;25932;83067;16062;137113;48435;185548
2017;13;Gran Bretaña;14524;23643;205557;731326;242743;1217793;846950;2064743
2017;13;Irlanda;179;3811;13159;29832;11274;58255;47176;105431
2017;13;Italia;2236;6888;28024;61162;10097;108407;43004;151411
2017;13;Suecia;297;4821;17842;54120;11440;88520;67124;155644
2017;13;Noruega;186;2847;6900;18216;5434;33583;40942;74525
2017;13;Dinamarca;165;6512;10568;27178;4833;49256;40371;89627
2017;13;Finlandia;222;1387;9752;25435;5705;42501;57760;100261
2017;13;Suiza;411;2700;5247;23106;16035;47499;9355;56854
2017;13;Austria;208;1368;3815;17108;6321;28820;7119;35939
2017;13;Rusia;803;2221;11858;25260;13395;53537;34609;88146
2017;13;Países del Este;725;4168;18304;75251;9211;107659;46030;153689
2017;13;Resto de Europa;1306;6567;28734;61217;16297;114121;51606;165727
2017;13;Estados Unidos;362;1006;2104;5661;7826;16959;4146;21105
2017;13;Resto de América;835;1826;3933;5143;3181;14918;4661;19579
2017;13;Resto del Mundo;1071;2852;6253;26183;16056;52415;14329;66744
2017;13;TOTAL;56812;183365;704033;2274081;629688;3847979;1856068;5704047
2018;1;España;1909;5084;9934;28268;7109;52304;9647;61951
2018;1;Holanda;51;402;1292;4682;992;7419;4563;11982
2018;1;Bélgica;62;198;856;8107;2496;11719;2344;14063
2018;1;Alemania;460;1443;7770;26523;5549;41745;9593;51338
2018;1;Francia;288;699;1574;6017;1188;9766;3559;13325
2018;1;Gran Bretaña;1162;2199;13659;51455;16576;85051;54689;139740
2018;1;Irlanda;42;270;962;2663;1189;5126;3304;8430
2018;1;Italia;228;487;2222;6285;1015;10237;4088;14325
2018;1;Suecia;71;563;2795;7887;1735;13051;10979;24030
2018;1;Noruega;32;299;973;2229;644;4177;5765;9942
2018;1;Dinamarca;40;734;1737;3967;746;7224;5659;12883
2018;1;Finlandia;42;228;1644;4212;742;6868;10184;17052
2018;1;Suiza;49;184;477;1429;994;3133;815;3948
2018;1;Austria;20;66;360;1319;393;2158;731;2889
2018;1;Rusia;88;321;1131;2419;1233;5192;2794;7986
2018;1;Países del Este;44;394;1340;5441;924;8143;4227;12370
2018;1;Resto de Europa;103;505;1682;3629;1048;6967;4491;11458
2018;1;Estados Unidos;23;102;130;440;382;1077;330;1407
2018;1;Resto de América;103;116;300;478;355;1352;311;1663
2018;1;Resto del Mundo;116;179;634;2370;1448;4747;791;5538
2018;1;TOTAL;4933;14473;51472;169820;46758;287456;138864;426320
2018;2;España;2005;4867;10775;27475;7354;52476;10048;62524
2018;2;Holanda;51;566;1344;5136;1384;8481;4948;13429
2018;2;Bélgica;85;240;916;7548;2622;11411;2176;13587
2018;2;Alemania;458;1215;7309;26043;6046;41071;10042;51113
2018;2;Francia;301;806;1936;7116;1414;11573;5160;16733
2018;2;Gran Bretaña;1236;2476;12986;53550;20315;90563;54462;145025
2018;2;Irlanda;24;314;871;2595;980;4784;2641;7425
2018;2;Italia;185;383;1768;5570;816;8722;3472;12194
2018;2;Suecia;31;432;2646;6316;1531;10956;9974;20930
2018;2;Noruega;26;349;1166;2279;1219;5039;6218;11257
2018;2;Dinamarca;44;805;1596;4083;769;7297;6507;13804
2018;2;Finlandia;28;254;1417;4051;1002;6752;10429;17181
2018;2;Suiza;60;178;453;1554;973;3218;679;3897
2018;2;Austria;16;80;329;1352;464;2241;665;2906
2018;2;Rusia;48;122;610;1027;526;2333;1472;3805
2018;2;Países del Este;57;334;1262;5652;708;8013;3682;11695
2018;2;Resto de Europa;78;532;1712;3708;1087;7117;4354;11471
2018;2;Estados Unidos;28;87;173;452;524;1264;269;1533
2018;2;Resto de América;88;112;242;444;535;1421;351;1772
2018;2;Resto del Mundo;133;185;736;3490;1651;6195;924;7119
2018;2;TOTAL;4982;14337;50247;169441;51920;290927;138473;429400
2018;3;España;2258;6154;14997;41373;10616;75398;21348;96746
2018;3;Holanda;45;363;1380;4586;1119;7493;4771;12264
2018;3;Bélgica;63;359;883;7089;2803;11197;2942;14139
2018;3;Alemania;510;1478;9455;30226;7106;48775;14012;62787
2018;3;Francia;323;830;2072;7769;1353;12347;4621;16968
2018;3;Gran Bretaña;1492;3161;15576;60649;22622;103500;65554;169054
2018;3;Irlanda;17;314;1041;3276;1471;6119;3239;9358
2018;3;Italia;216;551;1886;5063;1172;8888;2923;11811
2018;3;Suecia;26;367;2287;7185;1827;11692;9914;21606
2018;3;Noruega;19;364;948;2217;869;4417;5786;10203
2018;3;Dinamarca;40;427;1708;4206;835;7216;5802;13018
2018;3;Finlandia;12;205;1787;4318;871;7193;10107;17300
2018;3;Suiza;46;148;426;1738;992;3350;859;4209
2018;3;Austria;4;103;284;1226;552;2169;597;2766
2018;3;Rusia;48;155;532;1330;685;2750;2200;4950
2018;3;Países del Este;33;379;1566;6275;818;9071;3661;12732
2018;3;Resto de Europa;100;548;1982;4376;1594;8600;4326;12926
2018;3;Estados Unidos;31;162;306;815;765;2079;585;2664
2018;3;Resto de América;82;131;326;461;398;1398;375;1773
2018;3;Resto del Mundo;65;218;656;3157;1674;5770;1271;7041
2018;3;TOTAL;5430;16417;60098;197335;60142;339422;164893;504315
2018;4;España;1977;5191;16792;43105;8968;76033;22182;98215
2018;4;Holanda;31;282;1343;7205;1586;10447;7399;17846
2018;4;Bélgica;36;324;914;8335;2973;12582;2550;15132
2018;4;Alemania;251;1071;7161;24079;4880;37442;10327;47769
2018;4;Francia;356;737;2318;11286;1904;16601;6205;22806
2018;4;Gran Bretaña;1039;2139;14194;56258;22034;95664;65710;161374
2018;4;Irlanda;10;284;963;3147;1147;5551;3496;9047
2018;4;Italia;127;482;2012;5585;1263;9469;2898;12367
2018;4;Suecia;19;292;1175;3921;1025;6432;5273;11705
2018;4;Noruega;5;110;385;989;388;1877;2243;4120
2018;4;Dinamarca;2;331;808;1880;246;3267;2869;6136
2018;4;Finlandia;7;167;626;1511;318;2629;3489;6118
2018;4;Suiza;47;208;572;2231;1409;4467;1126;5593
2018;4;Austria;4;60;229;987;462;1742;422;2164
2018;4;Rusia;59;236;876;1809;956;3936;2801;6737
2018;4;Países del Este;57;482;1921;7197;858;10515;4511;15026
2018;4;Resto de Europa;96;366;2108;3445;1226;7241;4007;11248
2018;4;Estados Unidos;17;82;189;371;784;1443;484;1927
2018;4;Resto de América;60;120;454;496;269;1399;398;1797
2018;4;Resto del Mundo;50;182;492;3115;1198;5037;1260;6297
2018;4;TOTAL;4250;13146;55532;186952;53894;313774;149650;463424
2018;5;España;2040;6101;20739;52664;9449;90993;24576;115569
2018;5;Holanda;40;298;1340;6458;1615;9751;5674;15425
2018;5;Bélgica;11;166;663;5905;1992;8737;1790;10527
2018;5;Alemania;214;779;6453;25956;4887;38289;9509;47798
2018;5;Francia;276;875;1711;7941;1168;11971;3973;15944
2018;5;Gran Bretaña;1073;1524;15983;60933;17478;96991;72101;169092
2018;5;Irlanda;10;300;1406;3639;1147;6502;4112;10614
2018;5;Italia;178;404;1665;4054;677;6978;3061;10039
2018;5;Suecia;1;223;204;329;160;917;641;1558
2018;5;Noruega;3;171;98;163;116;551;601;1152
2018;5;Dinamarca;0;291;264;771;92;1418;919;2337
2018;5;Finlandia;5;12;179;334;198;728;729;1457
2018;5;Suiza;28;171;358;1709;968;3234;555;3789
2018;5;Austria;2;74;148;914;2366;3504;349;3853
2018;5;Rusia;51;170;893;1815;838;3767;2619;6386
2018;5;Países del Este;21;347;1425;6960;888;9641;4414;14055
2018;5;Resto de Europa;53;233;2271;3965;1103;7625;3118;10743
2018;5;Estados Unidos;33;84;143;420;372;1052;487;1539
2018;5;Resto de América;74;138;358;425;182;1177;527;1704
2018;5;Resto del Mundo;56;245;420;2758;825;4304;1392;5696
2018;5;TOTAL;4169;12606;56721;188113;46521;308130;141147;449277
2018;6;España;2096;6894;20058;58082;16047;103177;33677;136854
2018;6;Holanda;27;189;1089;5404;834;7543;4166;11709
2018;6;Bélgica;15;149;896;6278;1474;8812;1630;10442
2018;6;Alemania;186;589;6872;27984;4010;39641;9278;48919
2018;6;Francia;149;346;1705;6255;875;9330;3542;12872
2018;6;Gran Bretaña;1296;2351;17092;60826;17227;98792;81593;180385
2018;6;Irlanda;8;664;1385;3317;1110;6484;5880;12364
2018;6;Italia;123;357;1961;3562;835;6838;3438;10276
2018;6;Suecia;12;61;158;606;180;1017;618;1635
2018;6;Noruega;6;42;158;456;189;851;639;1490
2018;6;Dinamarca;1;367;134;438;54;994;554;1548
2018;6;Finlandia;8;16;51;89;117;281;393;674
2018;6;Suiza;18;114;309;1789;746;2976;499;3475
2018;6;Austria;10;49;197;1282;899;2437;374;2811
2018;6;Rusia;43;152;829;2120;820;3964;3367;7331
2018;6;Países del Este;42;400;1782;7110;1036;10370;5080;15450
2018;6;Resto de Europa;47;417;2063;5096;1146;8769;4459;13228
2018;6;Estados Unidos;22;75;228;535;1008;1868;461;2329
2018;6;Resto de América;66;134;253;484;356;1293;627;1920
2018;6;Resto del Mundo;52;170;372;2977;1004;4575;1263;5838
2018;6;TOTAL;4227;13536;57592;194690;49967;320012;161538;481550
2018;7;España;2305;6366;19090;66389;18128;112278;44019;156297
2018;7;Holanda;12;214;1757;7576;1300;10859;7296;18155
2018;7;Bélgica;31;178;1116;7613;2426;11364;2556;13920
2018;7;Alemania;169;709;7814;25552;4148;38392;13507;51899
2018;7;Francia;154;521;1698;8101;1420;11894;5187;17081
2018;7;Gran Bretaña;1099;1818;16828;59200;20587;99532;85497;185029
2018;7;Irlanda;5;599;1417;3040;1117;6178;6647;12825
2018;7;Italia;108;281;2293;4256;773;7711;3822;11533
2018;7;Suecia;3;55;294;566;136;1054;791;1845
2018;7;Noruega;5;67;262;963;212;1509;1472;2981
2018;7;Dinamarca;1;456;285;811;311;1864;1595;3459
2018;7;Finlandia;10;9;48;48;102;217;168;385
2018;7;Suiza;19;184;515;2454;1136;4308;1167;5475
2018;7;Austria;3;70;308;1363;574;2318;701;3019
2018;7;Rusia;52;174;762;1954;1189;4131;2854;6985
2018;7;Países del Este;61;364;1660;8051;1582;11718;4698;16416
2018;7;Resto de Europa;58;600;2953;6470;1583;11664;5395;17059
2018;7;Estados Unidos;35;55;110;533;630;1363;497;1860
2018;7;Resto de América;71;120;425;568;401;1585;648;2233
2018;7;Resto del Mundo;49;139;532;3752;1757;6229;1977;8206
2018;7;TOTAL;4250;12979;60167;209260;59512;346168;190494;536662
2018;8;España;2103;7254;21963;74097;23317;128734;52314;181048
2018;8;Holanda;28;237;1824;7680;1410;11179;8127;19306
2018;8;Bélgica;22;200;1159;6993;1933;10307;2272;12579
2018;8;Alemania;184;619;8113;25741;4406;39063;11941;51004
2018;8;Francia;243;567;1980;8966;2029;13785;5963;19748
2018;8;Gran Bretaña;1251;1790;15626;56947;20286;95900;91241;187141
2018;8;Irlanda;11;613;1529;2879;949;5981;5799;11780
2018;8;Italia;169;647;3191;5789;1167;10963;6096;17059
2018;8;Suecia;5;42;117;561;74;799;440;1239
2018;8;Noruega;0;34;53;387;99;573;419;992
2018;8;Dinamarca;5;126;138;601;105;975;506;1481
2018;8;Finlandia;0;8;15;21;44;88;86;174
2018;8;Suiza;8;82;318;1365;786;2559;566;3125
2018;8;Austria;10;47;209;1341;387;1994;527;2521
2018;8;Rusia;51;236;658;1978;1392;4315;2600;6915
2018;8;Países del Este;56;368;1742;7983;1394;11543;4939;16482
2018;8;Resto de Europa;32;489;2671;7180;1724;12096;4741;16837
2018;8;Estados Unidos;13;50;119;389;539;1110;500;1610
2018;8;Resto de América;90;116;400;511;277;1394;521;1915
2018;8;Resto del Mundo;57;228;665;4009;2212;7171;2195;9366
2018;8;TOTAL;4338;13753;62490;215418;64530;360529;201793;562322
2018;9;España;2320;6704;15726;52691;16756;94197;31880;126077
2018;9;Holanda;25;190;1244;5490;1406;8355;4820;13175
2018;9;Bélgica;32;153;932;6808;2273;10198;1994;12192
2018;9;Alemania;219;801;7309;26481;7032;41842;11785;53627
2018;9;Francia;189;511;1583;7460;1290;11033;3808;14841
2018;9;Gran Bretaña;1035;2030;15776;57704;19775;96320;78244;174564
2018;9;Irlanda;16;600;1336;3160;963;6075;5564;11639
2018;9;Italia;169;417;2060;3727;874;7247;3772;11019
2018;9;Suecia;4;78;240;537;108;967;774;1741
2018;9;Noruega;3;39;175;492;177;886;1009;1895
2018;9;Dinamarca;3;276;207;609;106;1201;800;2001
2018;9;Finlandia;8;29;61;247;83;428;503;931
2018;9;Suiza;7;190;426;1797;1528;3948;901;4849
2018;9;Austria;13;70;245;1226;409;1963;471;2434
2018;9;Rusia;44;217;845;1923;1168;4197;3015;7212
2018;9;Países del Este;73;388;2033;7337;1024;10855;4286;15141
2018;9;Resto de Europa;52;454;2174;5299;1467;9446;4609;14055
2018;9;Estados Unidos;34;92;128;386;744;1384;397;1781
2018;9;Resto de América;48;142;372;447;289;1298;581;1879
2018;9;Resto del Mundo;54;247;780;3312;1799;6192;1506;7698
2018;9;TOTAL;4348;13628;53652;187133;59271;318032;160719;478751
2018;10;España;2333;5419;15434;47127;12464;82777;24302;107079
2018;10;Holanda;9;188;1552;6802;1695;10246;5971;16217
2018;10;Bélgica;26;165;996;7490;3888;12565;2124;14689
2018;10;Alemania;360;1103;8307;28203;8139;46112;14142;60254
2018;10;Francia;304;710;1637;8505;2161;13317;5555;18872
2018;10;Gran Bretaña;1159;2342;16549;64722;26876;111648;81216;192864
2018;10;Irlanda;21;382;1124;3094;1094;5715;4714;10429
2018;10;Italia;149;378;2143;4811;878;8359;3592;11951
2018;10;Suecia;7;256;913;3545;921;5642;6663;12305
2018;10;Noruega;7;178;785;1609;409;2988;4586;7574
2018;10;Dinamarca;3;462;440;1582;343;2830;3388;6218
2018;10;Finlandia;25;191;526;2501;539;3782;6598;10380
2018;10;Suiza;24;317;702;2937;2286;6266;1736;8002
2018;10;Austria;21;86;266;1319;621;2313;538;2851
2018;10;Rusia;75;244;1088;2393;1289;5089;3697;8786
2018;10;Países del Este;48;528;1799;6575;1042;9992;4432;14424
2018;10;Resto de Europa;78;511;2227;4934;1555;9305;4798;14103
2018;10;Estados Unidos;18;64;172;417;680;1351;383;1734
2018;10;Resto de América;67;181;405;409;322;1384;472;1856
2018;10;Resto del Mundo;39;200;496;3371;1404;5510;1343;6853
2018;10;TOTAL;4773;13905;57561;202346;68606;347191;180250;527441
2018;11;España;2368;5437;13684;33887;8205;63581;12914;76495
2018;11;Holanda;85;270;1289;4692;1109;7445;4189;11634
2018;11;Bélgica;45;253;894;6289;3109;10590;2247;12837
2018;11;Alemania;466;1376;8976;29936;8124;48878;12960;61838
2018;11;Francia;274;679;939;4938;1036;7866;3201;11067
2018;11;Gran Bretaña;1315;2490;13957;55922;19626;93310;68652;161962
2018;11;Irlanda;22;373;879;2567;989;4830;3003;7833
2018;11;Italia;175;525;1862;4439;892;7893;3780;11673
2018;11;Suecia;66;446;2111;6596;1524;10743;8853;19596
2018;11;Noruega;16;321;930;2644;612;4523;6547;11070
2018;11;Dinamarca;13;492;866;2894;682;4947;5296;10243
2018;11;Finlandia;43;280;1774;4189;876;7162;9846;17008
2018;11;Suiza;47;241;430;2193;1575;4486;1034;5520
2018;11;Austria;33;97;352;1634;716;2832;854;3686
2018;11;Rusia;96;212;1117;2009;856;4290;3270;7560
2018;11;Países del Este;53;447;1688;6575;762;9525;4159;13684
2018;11;Resto de Europa;82;480;1790;3470;1319;7141;4024;11165
2018;11;Estados Unidos;22;100;206;557;751;1636;332;1968
2018;11;Resto de América;113;140;284;602;152;1291;302;1593
2018;11;Resto del Mundo;74;219;655;2694;1090;4732;1028;5760
2018;11;TOTAL;5408;14878;54683;178727;54005;307701;156491;464192
2018;12;España;2445;5735;13311;36662;11228;69381;15145;84526
2018;12;Holanda;45;376;1143;4868;1275;7707;4699;12406
2018;12;Bélgica;53;256;984;7734;3058;12085;2890;14975
2018;12;Alemania;407;1430;8402;23540;6498;40277;12980;53257
2018;12;Francia;359;627;1090;6215;1605;9896;4102;13998
2018;12;Gran Bretaña;1258;2183;14196;55260;21107;94004;67195;161199
2018;12;Irlanda;30;445;779;2486;1130;4870;3171;8041
2018;12;Italia;172;551;2152;5494;1354;9723;4447;14170
2018;12;Suecia;42;414;1887;7175;1381;10899;11045;21944
2018;12;Noruega;11;349;794;1931;586;3671;6067;9738
2018;12;Dinamarca;22;408;1223;3151;528;5332;6237;11569
2018;12;Finlandia;55;314;2030;4366;1046;7811;10944;18755
2018;12;Suiza;18;145;372;1610;1112;3257;838;4095
2018;12;Austria;16;111;363;1286;607;2383;810;3193
2018;12;Rusia;51;185;1828;1891;1143;5098;2475;7573
2018;12;Países del Este;55;506;1819;6227;1059;9666;4179;13845
2018;12;Resto de Europa;113;592;1784;3905;1708;8102;4712;12814
2018;12;Estados Unidos;23;106;198;583;853;1763;577;2340
2018;12;Resto de América;71;126;320;416;262;1195;406;1601
2018;12;Resto del Mundo;60;315;711;3323;1658;6067;2194;8261
2018;12;TOTAL;5306;15174;55386;178123;59198;313187;165113;478300
2018;13;España;26159;71206;192503;561820;149641;1001329;302052;1303381
2018;13;Holanda;449;3575;16597;70579;15725;106925;66623;173548
2018;13;Bélgica;481;2641;11209;86189;31047;131567;27515;159082
2018;13;Alemania;3884;12613;93941;320264;70825;501527;140076;641603
2018;13;Francia;3216;7908;20243;90569;17443;139379;54876;194255
2018;13;Gran Bretaña;14415;26503;182422;693426;244509;1161275;866154;2027429
2018;13;Irlanda;216;5158;13692;35863;13286;68215;51570;119785
2018;13;Italia;1999;5463;25215;58635;11716;103028;45389;148417
2018;13;Suecia;287;3229;14827;45224;10602;74169;65965;140134
2018;13;Noruega;133;2323;6727;16359;5520;31062;41352;72414
2018;13;Dinamarca;174;5175;9406;24993;4817;44565;40132;84697
2018;13;Finlandia;243;1713;10158;25887;5938;43939;63476;107415
2018;13;Suiza;371;2162;5358;22806;14505;45202;10775;55977
2018;13;Austria;152;913;3290;15249;8450;28054;7039;35093
2018;13;Rusia;706;2424;11169;22668;12095;49062;33164;82226
2018;13;Países del Este;600;4937;20037;81383;12095;119052;52268;171320
2018;13;Resto de Europa;892;5727;25417;55477;16560;104073;53034;157107
2018;13;Estados Unidos;299;1059;2102;5898;8032;17390;5302;22692
2018;13;Resto de América;933;1576;4139;5741;3798;16187;5519;21706
2018;13;Resto del Mundo;805;2527;7149;38328;17720;66529;17144;83673
2018;13;TOTAL;56414;168832;675601;2277358;674324;3852529;1949425;5801954
